token,tp_cases,tn_cases,fp_cases,fn_cases,total_cases,precision,recall,f1-score
wonderfull,0,0,1,0,1,0.0,#Div0,#Div0
study,0,46,7,0,53,0.0,#Div0,#Div0
claim,0,2,2,0,4,0.0,#Div0,#Div0
fight,0,0,0,4,4,#Div0,0.0,#Div0
sound,0,3,0,2,5,#Div0,0.0,#Div0
isolated,0,0,0,1,1,#Div0,0.0,#Div0
limitations,0,0,0,1,1,#Div0,0.0,#Div0
perception,0,0,0,1,1,#Div0,0.0,#Div0
Second,0,21,2,0,23,0.0,#Div0,#Div0
amny,0,0,1,0,1,0.0,#Div0,#Div0
dagerous,0,0,0,1,1,#Div0,0.0,#Div0
waste,1,0,0,5,6,1.0,0.16666666666666666,0.2857142857142857
comfortably,0,0,0,1,1,#Div0,0.0,#Div0
human,0,18,3,0,21,0.0,#Div0,#Div0
continous,0,0,1,0,1,0.0,#Div0,#Div0
color,0,4,0,1,5,#Div0,0.0,#Div0
promote,0,1,2,1,4,0.0,0.0,#Div0
most,0,95,0,1,96,#Div0,0.0,#Div0
important,0,116,6,0,122,0.0,#Div0,#Div0
do,0,212,138,0,350,0.0,#Div0,#Div0
insure,1,0,0,0,1,1.0,1.0,1.0
think,0,70,156,0,226,0.0,#Div0,#Div0
experienced,0,8,2,0,10,0.0,#Div0,#Div0
liek,0,0,1,0,1,0.0,#Div0,#Div0
complecated,0,0,1,0,1,0.0,#Div0,#Div0
develope,1,4,0,0,5,1.0,1.0,1.0
aspects,0,12,0,2,14,#Div0,0.0,#Div0
forigne,0,0,1,0,1,0.0,#Div0,#Div0
Agreeing,0,0,1,0,1,0.0,#Div0,#Div0
developed,1,8,1,1,11,0.5,0.5,0.5
breaking,0,0,0,1,1,#Div0,0.0,#Div0
beatiful,1,0,0,0,1,1.0,1.0,1.0
white-coloured,0,0,1,0,1,0.0,#Div0,#Div0
lack,0,5,0,2,7,#Div0,0.0,#Div0
impact,0,0,0,1,1,#Div0,0.0,#Div0
nesessarry,0,0,1,0,1,0.0,#Div0,#Div0
stress,0,4,2,0,6,0.0,#Div0,#Div0
underline,0,0,0,1,1,#Div0,0.0,#Div0
earned,0,0,0,2,2,#Div0,0.0,#Div0
abig,0,0,1,0,1,0.0,#Div0,#Div0
shoose,0,3,1,0,4,0.0,#Div0,#Div0
Doing,0,0,4,0,4,0.0,#Div0,#Div0
utopistic,0,0,1,0,1,0.0,#Div0,#Div0
comfortable,0,3,0,7,10,#Div0,0.0,#Div0
competition,0,0,0,1,1,#Div0,0.0,#Div0
line,0,1,0,3,4,#Div0,0.0,#Div0
Modern,0,0,1,0,1,0.0,#Div0,#Div0
struck,0,0,0,1,1,#Div0,0.0,#Div0
joung,0,1,1,0,2,0.0,#Div0,#Div0
connecting,0,0,0,1,1,#Div0,0.0,#Div0
pampered,1,0,0,0,1,1.0,1.0,1.0
tools,0,0,0,5,5,#Div0,0.0,#Div0
summary,0,2,1,0,3,0.0,#Div0,#Div0
d,0,4,1,0,5,0.0,#Div0,#Div0
mamage,0,0,0,1,1,#Div0,0.0,#Div0
experiment,0,4,0,1,5,#Div0,0.0,#Div0
complicatied,0,0,1,0,1,0.0,#Div0,#Div0
bring,0,3,1,4,8,0.0,0.0,#Div0
responds,0,0,0,1,1,#Div0,0.0,#Div0
discoverd,0,0,0,1,1,#Div0,0.0,#Div0
scarce,0,0,1,0,1,0.0,#Div0,#Div0
clean,0,3,1,0,4,0.0,#Div0,#Div0
Beeing,0,0,1,0,1,0.0,#Div0,#Div0
eyes,0,0,0,1,1,#Div0,0.0,#Div0
normal,0,6,3,0,9,0.0,#Div0,#Div0
found,0,19,0,1,20,#Div0,0.0,#Div0
neutral,0,0,0,1,1,#Div0,0.0,#Div0
trafic,0,0,1,0,1,0.0,#Div0,#Div0
Planning,0,0,1,0,1,0.0,#Div0,#Div0
exhaust,0,0,1,0,1,0.0,#Div0,#Div0
dreaming,0,0,0,1,1,#Div0,0.0,#Div0
valued,0,0,0,1,1,#Div0,0.0,#Div0
illustrated,0,1,0,1,2,#Div0,0.0,#Div0
COMPLETE,0,0,1,0,1,0.0,#Div0,#Div0
trave,0,1,1,0,2,0.0,#Div0,#Div0
data,0,4,1,0,5,0.0,#Div0,#Div0
show,0,13,7,0,20,0.0,#Div0,#Div0
focuses,0,0,0,3,3,#Div0,0.0,#Div0
shape,0,2,0,1,3,#Div0,0.0,#Div0
diminish,0,1,0,1,2,#Div0,0.0,#Div0
bond,0,0,0,1,1,#Div0,0.0,#Div0
meet,1,9,5,2,17,0.16666666666666666,0.3333333333333333,0.2222222222222222
platform,0,0,0,1,1,#Div0,0.0,#Div0
spreading,0,0,0,1,1,#Div0,0.0,#Div0
accidently,0,0,0,1,1,#Div0,0.0,#Div0
steady,2,0,0,2,4,1.0,0.5,0.6666666666666666
vertically,0,0,0,1,1,#Div0,0.0,#Div0
associate,0,0,1,0,1,0.0,#Div0,#Div0
telling,0,1,0,1,2,#Div0,0.0,#Div0
era,0,0,0,5,5,#Div0,0.0,#Div0
boths,0,0,1,0,1,0.0,#Div0,#Div0
brith,0,0,0,1,1,#Div0,0.0,#Div0
scratch,0,0,0,1,1,#Div0,0.0,#Div0
selfish,0,3,2,0,5,0.0,#Div0,#Div0
aspect,0,8,0,2,10,#Div0,0.0,#Div0
fantastic,1,0,1,0,2,0.5,1.0,0.6666666666666666
connection,0,0,0,5,5,#Div0,0.0,#Div0
activeusefull,1,0,0,0,1,1.0,1.0,1.0
went,0,14,0,1,15,#Div0,0.0,#Div0
lies,0,1,0,1,2,#Div0,0.0,#Div0
engine,0,0,0,2,2,#Div0,0.0,#Div0
maintain,0,2,1,0,3,0.0,#Div0,#Div0
poeple,0,4,1,0,5,0.0,#Div0,#Div0
mechanically,1,0,0,0,1,1.0,1.0,1.0
hassle,0,0,0,1,1,#Div0,0.0,#Div0
busy,0,11,0,2,13,#Div0,0.0,#Div0
valuable,0,2,0,2,4,#Div0,0.0,#Div0
predicted,0,0,1,0,1,0.0,#Div0,#Div0
multiple,0,0,1,0,1,0.0,#Div0,#Div0
thru,0,0,0,1,1,#Div0,0.0,#Div0
atomosphere,0,0,0,1,1,#Div0,0.0,#Div0
sector,0,1,0,1,2,#Div0,0.0,#Div0
remoivng,0,0,1,0,1,0.0,#Div0,#Div0
eliminates,0,0,0,1,1,#Div0,0.0,#Div0
correction,0,0,0,1,1,#Div0,0.0,#Div0
vanish,0,0,0,1,1,#Div0,0.0,#Div0
techological,0,0,1,0,1,0.0,#Div0,#Div0
aslo,0,0,1,0,1,0.0,#Div0,#Div0
guarantee,0,0,1,0,1,0.0,#Div0,#Div0
imposible,0,0,1,0,1,0.0,#Div0,#Div0
children,0,25,0,1,26,#Div0,0.0,#Div0
next,0,3,6,0,9,0.0,#Div0,#Div0
imposed,0,0,0,1,1,#Div0,0.0,#Div0
stems,0,0,0,1,1,#Div0,0.0,#Div0
understanding,0,29,3,0,32,0.0,#Div0,#Div0
ll,0,8,1,0,9,0.0,#Div0,#Div0
spend,14,7,6,23,50,0.7,0.3783783783783784,0.4912280701754387
hard,1,47,1,0,49,0.5,1.0,0.6666666666666666
deferent,0,0,1,0,1,0.0,#Div0,#Div0
powerful,1,0,0,0,1,1.0,1.0,1.0
jungle,0,0,0,1,1,#Div0,0.0,#Div0
twenty-five,0,0,1,0,1,0.0,#Div0,#Div0
undestand,0,2,1,0,3,0.0,#Div0,#Div0
run,3,0,1,4,8,0.75,0.42857142857142855,0.5454545454545454
love,0,8,3,0,11,0.0,#Div0,#Div0
build,2,2,0,4,8,1.0,0.3333333333333333,0.5
necessary,0,12,2,0,14,0.0,#Div0,#Div0
rough,0,0,1,1,2,0.0,0.0,#Div0
poor,0,11,1,0,12,0.0,#Div0,#Div0
away,0,7,0,5,12,#Div0,0.0,#Div0
year,0,19,0,1,20,#Div0,0.0,#Div0
concept,0,29,1,0,30,0.0,#Div0,#Div0
Many,0,3,9,0,12,0.0,#Div0,#Div0
protected,1,0,0,1,2,1.0,0.5,0.6666666666666666
asking,0,3,0,1,4,#Div0,0.0,#Div0
traditional,0,2,0,1,3,#Div0,0.0,#Div0
areas,0,6,0,1,7,#Div0,0.0,#Div0
ourself,0,3,1,0,4,0.0,#Div0,#Div0
5kg-plastic,0,0,1,0,1,0.0,#Div0,#Div0
gain,1,4,0,2,7,1.0,0.3333333333333333,0.5
earn,0,1,2,0,3,0.0,#Div0,#Div0
wiil,0,1,1,0,2,0.0,#Div0,#Div0
choosen,0,0,1,0,1,0.0,#Div0,#Div0
Total,0,0,1,0,1,0.0,#Div0,#Div0
downsides,0,0,0,1,1,#Div0,0.0,#Div0
socil,0,1,1,0,2,0.0,#Div0,#Div0
survive,0,2,0,2,4,#Div0,0.0,#Div0
stood,0,0,0,1,1,#Div0,0.0,#Div0
expressing,0,1,0,1,2,#Div0,0.0,#Div0
reflect,2,0,0,0,2,1.0,1.0,1.0
theit,0,0,1,0,1,0.0,#Div0,#Div0
teach,1,8,3,1,13,0.25,0.5,0.3333333333333333
refocus,1,0,0,0,1,1.0,1.0,1.0
t,0,5,4,0,9,0.0,#Div0,#Div0
behave,0,5,1,0,6,0.0,#Div0,#Div0
Human,0,0,1,0,1,0.0,#Div0,#Div0
two,0,32,0,1,33,#Div0,0.0,#Div0
successeful,0,0,1,0,1,0.0,#Div0,#Div0
embed,1,0,0,0,1,1.0,1.0,1.0
weak,1,0,0,3,4,1.0,0.25,0.4
advertized,0,0,1,0,1,0.0,#Div0,#Div0
specific,0,57,7,0,64,0.0,#Div0,#Div0
weight,0,1,0,1,2,#Div0,0.0,#Div0
providing,0,0,0,1,1,#Div0,0.0,#Div0
given,0,7,0,2,9,#Div0,0.0,#Div0
offcourse,0,0,1,0,1,0.0,#Div0,#Div0
reaching,0,0,0,5,5,#Div0,0.0,#Div0
reasearch,0,2,1,0,3,0.0,#Div0,#Div0
law,0,13,0,1,14,#Div0,0.0,#Div0
signs,0,0,0,1,1,#Div0,0.0,#Div0
challenging,0,8,0,1,9,#Div0,0.0,#Div0
margin,0,0,0,1,1,#Div0,0.0,#Div0
meaningless,0,0,0,1,1,#Div0,0.0,#Div0
Other,0,0,2,0,2,0.0,#Div0,#Div0
refer,0,0,1,0,1,0.0,#Div0,#Div0
limited,0,4,0,5,9,#Div0,0.0,#Div0
ecology,0,1,1,0,2,0.0,#Div0,#Div0
worlds,0,0,0,1,1,#Div0,0.0,#Div0
suggest,0,1,4,0,5,0.0,#Div0,#Div0
control,1,3,0,1,5,1.0,0.5,0.6666666666666666
background,0,7,0,3,10,#Div0,0.0,#Div0
untrue,0,0,1,0,1,0.0,#Div0,#Div0
kings,0,0,0,1,1,#Div0,0.0,#Div0
grade,0,2,1,1,4,0.0,0.0,#Div0
fly,0,0,1,0,1,0.0,#Div0,#Div0
building,0,5,0,1,6,#Div0,0.0,#Div0
fixed,0,0,0,1,1,#Div0,0.0,#Div0
disagree,0,13,33,0,46,0.0,#Div0,#Div0
eightteen,0,0,1,0,1,0.0,#Div0,#Div0
provide,2,6,4,1,13,0.3333333333333333,0.6666666666666666,0.4444444444444444
typical,0,0,4,0,4,0.0,#Div0,#Div0
tase,1,0,0,0,1,1.0,1.0,1.0
supplyment,0,0,0,1,1,#Div0,0.0,#Div0
arrange,0,0,1,0,1,0.0,#Div0,#Div0
go,5,41,30,5,81,0.14285714285714285,0.5,0.22222222222222224
alter,0,0,1,0,1,0.0,#Div0,#Div0
speacilize,0,1,1,0,2,0.0,#Div0,#Div0
position,0,6,0,3,9,#Div0,0.0,#Div0
Inter,0,0,1,0,1,0.0,#Div0,#Div0
spare,2,1,0,0,3,1.0,1.0,1.0
choose,0,17,5,0,22,0.0,#Div0,#Div0
advance,0,2,0,1,3,#Div0,0.0,#Div0
straight,0,0,0,1,1,#Div0,0.0,#Div0
dependant,0,0,1,0,1,0.0,#Div0,#Div0
crowd,0,0,0,1,1,#Div0,0.0,#Div0
dynamic,0,0,0,4,4,#Div0,0.0,#Div0
steps,0,0,0,2,2,#Div0,0.0,#Div0
loss,0,1,0,2,3,#Div0,0.0,#Div0
part,0,27,0,12,39,#Div0,0.0,#Div0
worry,0,3,1,0,4,0.0,#Div0,#Div0
roots,0,0,0,1,1,#Div0,0.0,#Div0
be,0,438,85,0,523,0.0,#Div0,#Div0
basis,0,1,0,3,4,#Div0,0.0,#Div0
chinese,0,0,4,0,4,0.0,#Div0,#Div0
pf,0,0,1,0,1,0.0,#Div0,#Div0
role,0,8,0,1,9,#Div0,0.0,#Div0
beautiful,0,5,1,0,6,0.0,#Div0,#Div0
17th-18th,0,0,1,0,1,0.0,#Div0,#Div0
personnal,0,0,1,0,1,0.0,#Div0,#Div0
healthy,1,9,0,0,10,1.0,1.0,1.0
calculate,0,0,1,1,2,0.0,0.0,#Div0
communicate,0,12,3,0,15,0.0,#Div0,#Div0
protect,0,1,0,3,4,#Div0,0.0,#Div0
second,1,5,8,0,14,0.1111111111111111,1.0,0.19999999999999998
complexities,0,0,0,1,1,#Div0,0.0,#Div0
say,0,29,32,0,61,0.0,#Div0,#Div0
consetrating,1,0,0,0,1,1.0,1.0,1.0
left,0,2,0,1,3,#Div0,0.0,#Div0
had,0,63,0,2,65,#Div0,0.0,#Div0
rainy,0,0,1,0,1,0.0,#Div0,#Div0
edge,0,0,0,1,1,#Div0,0.0,#Div0
supported,0,0,0,6,6,#Div0,0.0,#Div0
eminent,0,0,1,0,1,0.0,#Div0,#Div0
forming,0,0,0,2,2,#Div0,0.0,#Div0
asset,0,0,0,1,1,#Div0,0.0,#Div0
write,0,5,1,0,6,0.0,#Div0,#Div0
attribute,0,0,0,1,1,#Div0,0.0,#Div0
view,0,7,0,6,13,#Div0,0.0,#Div0
tempted,0,0,0,1,1,#Div0,0.0,#Div0
town,0,1,0,2,3,#Div0,0.0,#Div0
accept,0,2,2,0,4,0.0,#Div0,#Div0
attached,0,0,0,1,1,#Div0,0.0,#Div0
serve,0,0,0,1,1,#Div0,0.0,#Div0
autum,0,0,0,1,1,#Div0,0.0,#Div0
boosted,0,0,0,1,1,#Div0,0.0,#Div0
fruitfull,1,0,0,0,1,1.0,1.0,1.0
static,0,0,0,1,1,#Div0,0.0,#Div0
potencial,0,0,1,0,1,0.0,#Div0,#Div0
wheel,0,0,0,2,2,#Div0,0.0,#Div0
appriciate,0,0,0,3,3,#Div0,0.0,#Div0
opserve,0,0,1,0,1,0.0,#Div0,#Div0
generalistic,0,0,2,0,2,0.0,#Div0,#Div0
friends,0,28,1,0,29,0.0,#Div0,#Div0
safety,0,4,0,1,5,#Div0,0.0,#Div0
superficial,0,0,0,1,1,#Div0,0.0,#Div0
entreprenourial,0,0,1,0,1,0.0,#Div0,#Div0
entering,0,0,0,2,2,#Div0,0.0,#Div0
total,0,1,2,0,3,0.0,#Div0,#Div0
understand,0,56,35,0,91,0.0,#Div0,#Div0
electricity-powered,0,0,1,0,1,0.0,#Div0,#Div0
feel,2,23,18,1,44,0.1,0.6666666666666666,0.1739130434782609
generic,0,0,1,0,1,0.0,#Div0,#Div0
usefull,0,3,2,0,5,0.0,#Div0,#Div0
promise,0,0,1,0,1,0.0,#Div0,#Div0
foresee,0,0,1,0,1,0.0,#Div0,#Div0
plan,0,19,6,0,25,0.0,#Div0,#Div0
preserving,0,0,0,1,1,#Div0,0.0,#Div0
expanded,0,0,0,2,2,#Div0,0.0,#Div0
near,0,0,1,1,2,0.0,0.0,#Div0
beyond,0,0,0,2,2,#Div0,0.0,#Div0
and,0,1557,0,1,1558,#Div0,0.0,#Div0
challenge,0,2,0,1,3,#Div0,0.0,#Div0
mentaining,0,0,1,0,1,0.0,#Div0,#Div0
ranges,0,0,0,1,1,#Div0,0.0,#Div0
closed,0,0,0,1,1,#Div0,0.0,#Div0
Traveling,0,0,5,0,5,0.0,#Div0,#Div0
path,0,1,0,4,5,#Div0,0.0,#Div0
acidic,0,0,1,0,1,0.0,#Div0,#Div0
aintaining,1,0,0,0,1,1.0,1.0,1.0
safe,0,2,0,2,4,#Div0,0.0,#Div0
laud,0,0,1,0,1,0.0,#Div0,#Div0
too,0,47,0,3,50,#Div0,0.0,#Div0
emerge,0,0,0,1,1,#Div0,0.0,#Div0
guided,0,1,4,0,5,0.0,#Div0,#Div0
historical,0,4,1,0,5,0.0,#Div0,#Div0
late,0,5,0,2,7,#Div0,0.0,#Div0
contained,0,0,0,1,1,#Div0,0.0,#Div0
interesting,0,16,1,0,17,0.0,#Div0,#Div0
blend,0,0,0,1,1,#Div0,0.0,#Div0
born,0,3,0,2,5,#Div0,0.0,#Div0
cram,0,0,1,0,1,0.0,#Div0,#Div0
wasted,0,0,0,2,2,#Div0,0.0,#Div0
prefer,0,9,18,0,27,0.0,#Div0,#Div0
or,0,392,0,1,393,#Div0,0.0,#Div0
agroup,0,1,1,0,2,0.0,#Div0,#Div0
hate,0,2,1,0,3,0.0,#Div0,#Div0
quickly,0,6,0,1,7,#Div0,0.0,#Div0
covers,0,0,0,1,1,#Div0,0.0,#Div0
optimize,0,0,0,1,1,#Div0,0.0,#Div0
value,0,2,0,2,4,#Div0,0.0,#Div0
at,0,130,0,1,131,#Div0,0.0,#Div0
uncontrollable,0,0,1,0,1,0.0,#Div0,#Div0
potentials,0,0,0,1,1,#Div0,0.0,#Div0
recover,0,0,1,0,1,0.0,#Div0,#Div0
cleary,0,0,0,1,1,#Div0,0.0,#Div0
impression,0,7,0,1,8,#Div0,0.0,#Div0
successfull,0,1,1,0,2,0.0,#Div0,#Div0
complexe,0,2,1,0,3,0.0,#Div0,#Div0
creamy,0,1,1,0,2,0.0,#Div0,#Div0
sell,0,6,2,0,8,0.0,#Div0,#Div0
mine,0,2,1,0,3,0.0,#Div0,#Div0
diffrent,0,4,7,0,11,0.0,#Div0,#Div0
roam,0,0,0,1,1,#Div0,0.0,#Div0
sign,0,1,0,2,3,#Div0,0.0,#Div0
in,0,1100,0,18,1118,#Div0,0.0,#Div0
fitting,0,0,0,1,1,#Div0,0.0,#Div0
saw,0,4,4,0,8,0.0,#Div0,#Div0
flowing,0,0,0,1,1,#Div0,0.0,#Div0
memorizing,0,3,1,0,4,0.0,#Div0,#Div0
discount,0,0,1,0,1,0.0,#Div0,#Div0
specialize,0,16,6,0,22,0.0,#Div0,#Div0
endure,0,0,0,1,1,#Div0,0.0,#Div0
along,0,2,1,0,3,0.0,#Div0,#Div0
affect,0,2,1,0,3,0.0,#Div0,#Div0
definite,0,0,1,0,1,0.0,#Div0,#Div0
reduces,0,0,0,1,1,#Div0,0.0,#Div0
evolution,0,0,0,1,1,#Div0,0.0,#Div0
beleive,0,2,2,0,4,0.0,#Div0,#Div0
esthetic,0,0,1,0,1,0.0,#Div0,#Div0
Enjoying,0,0,2,0,2,0.0,#Div0,#Div0
small,1,6,6,3,16,0.14285714285714285,0.25,0.18181818181818182
diffused,1,0,0,0,1,1.0,1.0,1.0
Specializing,0,0,2,0,2,0.0,#Div0,#Div0
consums,0,0,1,0,1,0.0,#Div0,#Div0
more,0,411,0,3,414,#Div0,0.0,#Div0
to,0,2038,0,3,2041,#Div0,0.0,#Div0
permanent,0,0,1,0,1,0.0,#Div0,#Div0
Let,0,1,1,0,2,0.0,#Div0,#Div0
dance,0,2,1,0,3,0.0,#Div0,#Div0
microsoft,0,0,1,0,1,0.0,#Div0,#Div0
decline,0,1,1,0,2,0.0,#Div0,#Div0
semesters,0,0,0,1,1,#Div0,0.0,#Div0
sons,0,0,0,1,1,#Div0,0.0,#Div0
vision,0,1,0,3,4,#Div0,0.0,#Div0
simple,0,5,3,1,9,0.0,0.0,#Div0
begin,0,2,1,0,3,0.0,#Div0,#Div0
cheap,0,6,1,1,8,0.0,0.0,#Div0
replace,0,0,1,0,1,0.0,#Div0,#Div0
create,0,6,2,2,10,0.0,0.0,#Div0
fast,0,7,0,2,9,#Div0,0.0,#Div0
Travelling,0,1,3,0,4,0.0,#Div0,#Div0
intoduced,0,0,0,1,1,#Div0,0.0,#Div0
interact,0,5,0,1,6,#Div0,0.0,#Div0
later,0,6,0,1,7,#Div0,0.0,#Div0
into,0,11,0,11,22,#Div0,0.0,#Div0
insist,0,0,1,0,1,0.0,#Div0,#Div0
nt,0,112,17,0,129,0.0,#Div0,#Div0
reapeat,0,0,1,0,1,0.0,#Div0,#Div0
overtaken,0,0,0,1,1,#Div0,0.0,#Div0
following,0,9,0,1,10,#Div0,0.0,#Div0
keep-it-safe,0,0,0,1,1,#Div0,0.0,#Div0
wolud,0,0,1,0,1,0.0,#Div0,#Div0
addicted,0,0,0,1,1,#Div0,0.0,#Div0
step,0,1,0,3,4,#Div0,0.0,#Div0
dissoponited,0,0,1,0,1,0.0,#Div0,#Div0
last,0,3,7,2,12,0.0,0.0,#Div0
satisfy,0,1,1,0,2,0.0,#Div0,#Div0
full,1,2,2,12,17,0.3333333333333333,0.07692307692307693,0.125
agree,0,33,59,0,92,0.0,#Div0,#Div0
complete,0,3,1,2,6,0.0,0.0,#Div0
react,0,3,2,0,5,0.0,#Div0,#Div0
phases,0,0,0,1,1,#Div0,0.0,#Div0
loses,0,0,0,1,1,#Div0,0.0,#Div0
arm,0,0,0,1,1,#Div0,0.0,#Div0
Sorses,0,0,0,1,1,#Div0,0.0,#Div0
cambodian,0,0,1,0,1,0.0,#Div0,#Div0
ruin,0,0,0,1,1,#Div0,0.0,#Div0
hectic,1,0,0,0,1,1.0,1.0,1.0
shrink,0,0,0,1,1,#Div0,0.0,#Div0
fresh,1,2,0,1,4,1.0,0.5,0.6666666666666666
enable,0,1,1,0,2,0.0,#Div0,#Div0
contributing,0,0,0,1,1,#Div0,0.0,#Div0
behavior,0,10,1,0,11,0.0,#Div0,#Div0
eye,0,1,0,1,2,#Div0,0.0,#Div0
held,0,0,0,1,1,#Div0,0.0,#Div0
progres,0,0,0,1,1,#Div0,0.0,#Div0
cefeman,0,0,1,0,1,0.0,#Div0,#Div0
close,0,3,0,4,7,#Div0,0.0,#Div0
forced,0,0,0,4,4,#Div0,0.0,#Div0
stick,0,0,0,2,2,#Div0,0.0,#Div0
collecting,0,0,0,1,1,#Div0,0.0,#Div0
hobby,0,1,1,0,2,0.0,#Div0,#Div0
Use,1,0,0,0,1,1.0,1.0,1.0
ridiculous,0,0,1,0,1,0.0,#Div0,#Div0
simulataneous,0,0,1,0,1,0.0,#Div0,#Div0
having,0,45,0,5,50,#Div0,0.0,#Div0
brave,0,4,4,0,8,0.0,#Div0,#Div0
self,0,12,2,0,14,0.0,#Div0,#Div0
One,0,13,0,1,14,#Div0,0.0,#Div0
persuing,0,0,0,1,1,#Div0,0.0,#Div0
rise,1,1,0,0,2,1.0,1.0,1.0
Travering,0,1,1,0,2,0.0,#Div0,#Div0
devastating,0,0,0,1,1,#Div0,0.0,#Div0
original,0,1,1,1,3,0.0,0.0,#Div0
acadimic,0,0,1,0,1,0.0,#Div0,#Div0
short,0,10,3,1,14,0.0,0.0,#Div0
collect,0,0,1,0,1,0.0,#Div0,#Div0
Intelligent,0,0,1,0,1,0.0,#Div0,#Div0
improvment,0,0,0,1,1,#Div0,0.0,#Div0
Living,0,0,1,0,1,0.0,#Div0,#Div0
perticipate,0,0,1,0,1,0.0,#Div0,#Div0
green-house,1,0,0,0,1,1.0,1.0,1.0
coin,0,0,0,1,1,#Div0,0.0,#Div0
Trying,0,0,1,0,1,0.0,#Div0,#Div0
backgrounds,0,1,0,1,2,#Div0,0.0,#Div0
address,0,0,1,0,1,0.0,#Div0,#Div0
happen,0,5,3,0,8,0.0,#Div0,#Div0
imagine,0,2,1,0,3,0.0,#Div0,#Div0
lower,0,4,0,1,5,#Div0,0.0,#Div0
exepensive,0,0,1,0,1,0.0,#Div0,#Div0
restrictions,0,0,0,2,2,#Div0,0.0,#Div0
surronded,0,0,0,1,1,#Div0,0.0,#Div0
leass,0,0,1,0,1,0.0,#Div0,#Div0
bit,0,2,0,1,3,#Div0,0.0,#Div0
privaite,0,0,1,0,1,0.0,#Div0,#Div0
catholic,0,0,2,0,2,0.0,#Div0,#Div0
dedicate,3,0,1,4,8,0.75,0.42857142857142855,0.5454545454545454
craizy,0,0,0,1,1,#Div0,0.0,#Div0
fat,0,0,1,0,1,0.0,#Div0,#Div0
promenet,0,0,0,1,1,#Div0,0.0,#Div0
intend,0,2,1,0,3,0.0,#Div0,#Div0
reachable,0,0,0,1,1,#Div0,0.0,#Div0
circle,0,0,0,1,1,#Div0,0.0,#Div0
whole,0,6,2,2,10,0.0,0.0,#Div0
cause,0,11,4,0,15,0.0,#Div0,#Div0
meaninngless,0,0,0,1,1,#Div0,0.0,#Div0
scheme,0,0,0,1,1,#Div0,0.0,#Div0
horrorfy,0,0,1,0,1,0.0,#Div0,#Div0
faced,0,0,0,1,1,#Div0,0.0,#Div0
Successful,0,0,4,0,4,0.0,#Div0,#Div0
trucks,0,0,0,1,1,#Div0,0.0,#Div0
vegetable,0,3,1,0,4,0.0,#Div0,#Div0
advantage,0,3,0,2,5,#Div0,0.0,#Div0
archeological,0,0,1,0,1,0.0,#Div0,#Div0
known,0,16,1,0,17,0.0,#Div0,#Div0
phisical,0,0,1,0,1,0.0,#Div0,#Div0
concentrates,0,0,0,1,1,#Div0,0.0,#Div0
get,6,43,34,7,90,0.15,0.46153846153846156,0.22641509433962265
supecial,0,0,1,0,1,0.0,#Div0,#Div0
become,0,26,13,2,41,0.0,0.0,#Div0
belong,2,0,0,0,2,1.0,1.0,1.0
driven,0,0,0,1,1,#Div0,0.0,#Div0
cutting-edge,0,0,0,1,1,#Div0,0.0,#Div0
tolerating,0,0,0,1,1,#Div0,0.0,#Div0
Acording,0,0,1,0,1,0.0,#Div0,#Div0
Exellent,0,0,1,0,1,0.0,#Div0,#Div0
instruments,0,1,0,1,2,#Div0,0.0,#Div0
credible,0,0,1,0,1,0.0,#Div0,#Div0
broader,0,0,0,6,6,#Div0,0.0,#Div0
tecnological,0,0,3,0,3,0.0,#Div0,#Div0
defence,0,0,0,1,1,#Div0,0.0,#Div0
try,0,43,29,0,72,0.0,#Div0,#Div0
guide,0,122,1,2,125,0.0,0.0,#Div0
nobel,0,0,1,0,1,0.0,#Div0,#Div0
regret,0,0,1,0,1,0.0,#Div0,#Div0
attact,0,0,0,1,1,#Div0,0.0,#Div0
environement,0,0,0,1,1,#Div0,0.0,#Div0
basesd,0,0,0,1,1,#Div0,0.0,#Div0
off,0,3,0,1,4,#Div0,0.0,#Div0
explore,2,2,0,1,5,1.0,0.6666666666666666,0.8
prove,0,3,1,0,4,0.0,#Div0,#Div0
cheat,0,0,0,1,1,#Div0,0.0,#Div0
misleading,1,0,0,2,3,1.0,0.3333333333333333,0.5
worthless,1,0,0,1,2,1.0,0.5,0.6666666666666666
direction,0,1,0,2,3,#Div0,0.0,#Div0
bound,0,0,0,2,2,#Div0,0.0,#Div0
guess,0,3,2,0,5,0.0,#Div0,#Div0
marine,0,0,1,0,1,0.0,#Div0,#Div0
written,0,5,0,1,6,#Div0,0.0,#Div0
act,0,1,1,0,2,0.0,#Div0,#Div0
golden,1,0,0,0,1,1.0,1.0,1.0
smooth,0,0,0,1,1,#Div0,0.0,#Div0
recommend,0,0,1,0,1,0.0,#Div0,#Div0
wrning,0,0,0,1,1,#Div0,0.0,#Div0
uderstanding,0,0,1,0,1,0.0,#Div0,#Div0
hold,2,0,0,0,2,1.0,1.0,1.0
fits,0,0,0,2,2,#Div0,0.0,#Div0
call,0,3,4,0,7,0.0,#Div0,#Div0
flexible,2,0,0,1,3,1.0,0.6666666666666666,0.8
illeterate,0,0,1,0,1,0.0,#Div0,#Div0
enlargement,0,0,0,1,1,#Div0,0.0,#Div0
peak,0,0,0,1,1,#Div0,0.0,#Div0
decair,0,0,1,0,1,0.0,#Div0,#Div0
adjust,0,1,0,1,2,#Div0,0.0,#Div0
mechanical,0,2,1,0,3,0.0,#Div0,#Div0
provided,0,8,1,0,9,0.0,#Div0,#Div0
elderly,0,1,1,0,2,0.0,#Div0,#Div0
start,0,14,8,3,25,0.0,0.0,#Div0
reduce,1,0,0,0,1,1.0,1.0,1.0
mislead,0,0,0,1,1,#Div0,0.0,#Div0
harm,0,1,0,1,2,#Div0,0.0,#Div0
percent,0,1,0,1,2,#Div0,0.0,#Div0
prepare,0,0,1,1,2,0.0,0.0,#Div0
direvered,1,0,0,0,1,1.0,1.0,1.0
little,0,14,12,2,28,0.0,0.0,#Div0
beleve,0,0,1,0,1,0.0,#Div0,#Div0
overwhelm,0,0,0,1,1,#Div0,0.0,#Div0
connected,0,2,0,2,4,#Div0,0.0,#Div0
other,0,138,39,1,178,0.0,0.0,#Div0
places,0,43,0,1,44,#Div0,0.0,#Div0
from,0,166,0,12,178,#Div0,0.0,#Div0
enter,0,3,1,0,4,0.0,#Div0,#Div0
follwing,0,0,1,0,1,0.0,#Div0,#Div0
social,0,18,3,0,21,0.0,#Div0,#Div0
courage,0,6,0,1,7,#Div0,0.0,#Div0
drive,0,5,0,1,6,#Div0,0.0,#Div0
mess,0,0,0,1,1,#Div0,0.0,#Div0
moved,0,4,0,2,6,#Div0,0.0,#Div0
opener,0,0,0,1,1,#Div0,0.0,#Div0
led,0,28,0,1,29,#Div0,0.0,#Div0
spenting,0,0,0,1,1,#Div0,0.0,#Div0
concentrated,0,0,0,1,1,#Div0,0.0,#Div0
rewarding,0,2,0,2,4,#Div0,0.0,#Div0
wach,0,0,2,0,2,0.0,#Div0,#Div0
free,11,7,1,3,22,0.9166666666666666,0.7857142857142857,0.8461538461538461
key,0,1,0,3,4,#Div0,0.0,#Div0
speak,0,6,6,0,12,0.0,#Div0,#Div0
informational,0,0,1,0,1,0.0,#Div0,#Div0
eintire,0,0,1,0,1,0.0,#Div0,#Div0
old-men,0,0,0,1,1,#Div0,0.0,#Div0
village,0,0,0,1,1,#Div0,0.0,#Div0
lettel,0,0,1,0,1,0.0,#Div0,#Div0
around,0,32,0,3,35,#Div0,0.0,#Div0
produce,1,4,3,0,8,0.25,1.0,0.4
live,0,29,17,0,46,0.0,#Div0,#Div0
profitable,0,0,1,0,1,0.0,#Div0,#Div0
angles,0,1,0,1,2,#Div0,0.0,#Div0
active,0,0,0,5,5,#Div0,0.0,#Div0
native,0,0,1,0,1,0.0,#Div0,#Div0
Take,0,1,1,0,2,0.0,#Div0,#Div0
various,0,2,9,0,11,0.0,#Div0,#Div0
throw,0,0,0,1,1,#Div0,0.0,#Div0
good,0,97,33,0,130,0.0,#Div0,#Div0
target,0,0,0,1,1,#Div0,0.0,#Div0
developing,0,7,1,1,9,0.0,0.0,#Div0
playing,0,5,0,2,7,#Div0,0.0,#Div0
closer,0,0,0,1,1,#Div0,0.0,#Div0
attractions,0,0,0,1,1,#Div0,0.0,#Div0
isolte,0,0,0,1,1,#Div0,0.0,#Div0
knowled,0,0,0,1,1,#Div0,0.0,#Div0
sight,0,2,0,1,3,#Div0,0.0,#Div0
gaining,0,1,0,1,2,#Div0,0.0,#Div0
stores,0,2,0,1,3,#Div0,0.0,#Div0
fullfilling,1,1,0,0,2,1.0,1.0,1.0
turn,1,2,0,2,5,1.0,0.3333333333333333,0.5
economical,0,2,2,0,4,0.0,#Div0,#Div0
takes,0,5,0,6,11,#Div0,0.0,#Div0
measure,1,0,0,1,2,1.0,0.5,0.6666666666666666
emphasize,0,1,1,0,2,0.0,#Div0,#Div0
real,0,28,6,0,34,0.0,#Div0,#Div0
far,0,7,0,5,12,#Div0,0.0,#Div0
cheet,0,0,0,1,1,#Div0,0.0,#Div0
revolution,0,0,0,3,3,#Div0,0.0,#Div0
italian,0,0,2,0,2,0.0,#Div0,#Div0
time,0,289,0,2,291,#Div0,0.0,#Div0
incorrect,1,1,0,0,2,1.0,1.0,1.0
pushs,0,0,0,1,1,#Div0,0.0,#Div0
fun,0,17,3,0,20,0.0,#Div0,#Div0
actor,0,0,0,1,1,#Div0,0.0,#Div0
of,0,1325,0,9,1334,#Div0,0.0,#Div0
obliges,0,0,0,1,1,#Div0,0.0,#Div0
voices,0,0,0,1,1,#Div0,0.0,#Div0
prefare,0,0,1,0,1,0.0,#Div0,#Div0
attractive,0,0,1,0,1,0.0,#Div0,#Div0
class,0,17,0,1,18,#Div0,0.0,#Div0
Meeting,0,0,1,0,1,0.0,#Div0,#Div0
alot,0,20,2,0,22,0.0,#Div0,#Div0
grasping,0,0,0,1,1,#Div0,0.0,#Div0
eventualy,0,0,1,0,1,0.0,#Div0,#Div0
revolutianized,0,0,1,0,1,0.0,#Div0,#Div0
wast,0,0,0,2,2,#Div0,0.0,#Div0
compel,0,0,0,1,1,#Div0,0.0,#Div0
balance,0,0,0,1,1,#Div0,0.0,#Div0
third,0,0,1,0,1,0.0,#Div0,#Div0
sustaine,1,0,0,0,1,1.0,1.0,1.0
fulfill,0,0,0,1,1,#Div0,0.0,#Div0
encounter,1,0,0,0,1,1.0,1.0,1.0
black,0,0,1,0,1,0.0,#Div0,#Div0
relaiable,0,1,1,0,2,0.0,#Div0,#Div0
solve,0,4,4,0,8,0.0,#Div0,#Div0
tough,0,4,0,1,5,#Div0,0.0,#Div0
struggle,0,0,0,1,1,#Div0,0.0,#Div0
devoting,0,0,0,1,1,#Div0,0.0,#Div0
Advancement,0,0,0,1,1,#Div0,0.0,#Div0
proactive,0,0,1,0,1,0.0,#Div0,#Div0
Considering,0,3,1,0,4,0.0,#Div0,#Div0
torist,0,0,1,0,1,0.0,#Div0,#Div0
achieved,0,3,0,1,4,#Div0,0.0,#Div0
ecological,0,1,2,0,3,0.0,#Div0,#Div0
broadn,1,0,0,0,1,1.0,1.0,1.0
spring,0,0,0,1,1,#Div0,0.0,#Div0
biological,0,0,1,0,1,0.0,#Div0,#Div0
tasteless,0,0,0,1,1,#Div0,0.0,#Div0
intense,1,0,0,0,1,1.0,1.0,1.0
like,0,119,16,0,135,0.0,#Div0,#Div0
adventure,0,5,0,1,6,#Div0,0.0,#Div0
ask,0,6,5,0,11,0.0,#Div0,#Div0
taught,0,7,0,1,8,#Div0,0.0,#Div0
Thats,0,0,1,0,1,0.0,#Div0,#Div0
bright,1,0,1,0,2,0.5,1.0,0.6666666666666666
nightmare,0,0,0,1,1,#Div0,0.0,#Div0
underlining,0,0,0,1,1,#Div0,0.0,#Div0
relationship,0,2,0,1,3,#Div0,0.0,#Div0
model,0,5,0,1,6,#Div0,0.0,#Div0
judging,0,0,0,1,1,#Div0,0.0,#Div0
size,0,3,1,0,4,0.0,#Div0,#Div0
narrow,0,0,0,3,3,#Div0,0.0,#Div0
happeded,0,0,1,0,1,0.0,#Div0,#Div0
fanatic,1,0,0,0,1,1.0,1.0,1.0
shoulders,0,0,0,2,2,#Div0,0.0,#Div0
summarize,0,0,2,0,2,0.0,#Div0,#Div0
soft,0,0,0,1,1,#Div0,0.0,#Div0
obstacle,0,0,0,2,2,#Div0,0.0,#Div0
horizental,1,0,0,2,3,1.0,0.3333333333333333,0.5
punced,0,0,1,0,1,0.0,#Div0,#Div0
science,0,7,1,0,8,0.0,#Div0,#Div0
huge,0,9,2,1,12,0.0,0.0,#Div0
suppoting,0,0,0,1,1,#Div0,0.0,#Div0
wake,0,1,2,0,3,0.0,#Div0,#Div0
mountenious,0,0,1,0,1,0.0,#Div0,#Div0
educated,0,8,1,0,9,0.0,#Div0,#Div0
very,0,128,0,1,129,#Div0,0.0,#Div0
way,0,104,0,6,110,#Div0,0.0,#Div0
cultural,0,2,4,0,6,0.0,#Div0,#Div0
sharp,0,0,0,1,1,#Div0,0.0,#Div0
Taking,0,1,0,1,2,#Div0,0.0,#Div0
tied,0,0,0,1,1,#Div0,0.0,#Div0
avoid,1,2,5,0,8,0.16666666666666666,1.0,0.2857142857142857
giving,0,6,0,4,10,#Div0,0.0,#Div0
discovery,0,1,0,3,4,#Div0,0.0,#Div0
global,0,3,5,0,8,0.0,#Div0,#Div0
part-time,0,0,1,0,1,0.0,#Div0,#Div0
shattered,0,0,0,1,1,#Div0,0.0,#Div0
allocating,0,0,0,1,1,#Div0,0.0,#Div0
many,0,74,146,0,220,0.0,#Div0,#Div0
foregin,0,0,3,0,3,0.0,#Div0,#Div0
taste,0,0,0,3,3,#Div0,0.0,#Div0
bad,0,13,4,0,17,0.0,#Div0,#Div0
nice,0,8,2,0,10,0.0,#Div0,#Div0
math,0,9,1,0,10,0.0,#Div0,#Div0
getting,0,21,0,1,22,#Div0,0.0,#Div0
yong,0,0,3,0,3,0.0,#Div0,#Div0
relative,0,0,2,0,2,0.0,#Div0,#Div0
first,2,13,23,0,38,0.08,1.0,0.14814814814814814
settle,0,0,0,1,1,#Div0,0.0,#Div0
Such,0,2,1,0,3,0.0,#Div0,#Div0
solid,0,0,0,1,1,#Div0,0.0,#Div0
age,0,21,0,2,23,#Div0,0.0,#Div0
warmly,0,0,0,1,1,#Div0,0.0,#Div0
supervise,0,0,1,0,1,0.0,#Div0,#Div0
dispose,0,0,0,1,1,#Div0,0.0,#Div0
this,0,309,0,1,310,#Div0,0.0,#Div0
fill,1,0,0,1,2,1.0,0.5,0.6666666666666666
facilite,0,0,1,0,1,0.0,#Div0,#Div0
speacilizing,0,0,1,0,1,0.0,#Div0,#Div0
benificial,0,0,2,0,2,0.0,#Div0,#Div0
grows,0,0,0,1,1,#Div0,0.0,#Div0
deal,1,2,0,0,3,1.0,1.0,1.0
pressures,0,0,0,2,2,#Div0,0.0,#Div0
killers,0,0,0,1,1,#Div0,0.0,#Div0
richness,0,0,0,1,1,#Div0,0.0,#Div0
useless,2,3,1,0,6,0.6666666666666666,1.0,0.8
exotic,0,0,0,1,1,#Div0,0.0,#Div0
throught,0,1,2,0,3,0.0,#Div0,#Div0
linked,0,0,0,1,1,#Div0,0.0,#Div0
energy,0,23,0,1,24,#Div0,0.0,#Div0
channels,0,0,0,1,1,#Div0,0.0,#Div0
advanced,1,3,2,1,7,0.3333333333333333,0.5,0.4
made,0,32,0,1,33,#Div0,0.0,#Div0
reject,0,0,0,1,1,#Div0,0.0,#Div0
easy,0,20,1,1,22,0.0,0.0,#Div0
priceless,0,0,0,1,1,#Div0,0.0,#Div0
deny,0,1,2,0,3,0.0,#Div0,#Div0
dont,0,9,6,0,15,0.0,#Div0,#Div0
Simple,0,0,1,0,1,0.0,#Div0,#Div0
constraints,0,0,0,1,1,#Div0,0.0,#Div0
approaching,0,0,0,1,1,#Div0,0.0,#Div0
graps,1,0,0,0,1,1.0,1.0,1.0
loyalty,0,1,0,1,2,#Div0,0.0,#Div0
risk,0,19,0,1,20,#Div0,0.0,#Div0
several,0,3,14,0,17,0.0,#Div0,#Div0
care,0,18,4,0,22,0.0,#Div0,#Div0
widening,0,0,0,1,1,#Div0,0.0,#Div0
collage,0,0,0,1,1,#Div0,0.0,#Div0
help,1,84,47,1,133,0.020833333333333332,0.5,0.039999999999999994
fought,0,0,0,1,1,#Div0,0.0,#Div0
oun,0,0,1,0,1,0.0,#Div0,#Div0
believe,0,17,46,0,63,0.0,#Div0,#Div0
neo,0,0,1,0,1,0.0,#Div0,#Div0
eloquent,1,0,0,0,1,1.0,1.0,1.0
cut,0,2,0,1,3,#Div0,0.0,#Div0
optimistic,0,2,1,0,3,0.0,#Div0,#Div0
expert,0,5,2,0,7,0.0,#Div0,#Div0
expect,0,1,1,0,2,0.0,#Div0,#Div0
set,0,1,1,0,2,0.0,#Div0,#Div0
intensity,0,0,0,1,1,#Div0,0.0,#Div0
focus,4,0,0,8,12,1.0,0.3333333333333333,0.5
few,0,3,25,0,28,0.0,#Div0,#Div0
theorical,0,0,3,0,3,0.0,#Div0,#Div0
noisy,0,0,2,0,2,0.0,#Div0,#Div0
defend,1,0,0,0,1,1.0,1.0,1.0
great,1,19,5,0,25,0.16666666666666666,1.0,0.2857142857142857
virtue,0,0,0,1,1,#Div0,0.0,#Div0
draw,0,1,0,1,2,#Div0,0.0,#Div0
metropolitan,0,1,1,0,2,0.0,#Div0,#Div0
zoo,0,0,0,1,1,#Div0,0.0,#Div0
exercise,0,4,1,0,5,0.0,#Div0,#Div0
goal,0,15,0,3,18,#Div0,0.0,#Div0
demanding,0,0,0,1,1,#Div0,0.0,#Div0
calm,1,0,0,0,1,1.0,1.0,1.0
junk,0,0,0,2,2,#Div0,0.0,#Div0
multiplying,0,0,0,1,1,#Div0,0.0,#Div0
competing,0,0,0,2,2,#Div0,0.0,#Div0
has,0,139,0,5,144,#Div0,0.0,#Div0
requires,0,10,0,3,13,#Div0,0.0,#Div0
door,0,0,0,1,1,#Div0,0.0,#Div0
mostof,0,0,1,0,1,0.0,#Div0,#Div0
thirst,0,0,0,1,1,#Div0,0.0,#Div0
outside,0,3,0,2,5,#Div0,0.0,#Div0
Big,0,0,1,0,1,0.0,#Div0,#Div0
enjoy,0,60,47,0,107,0.0,#Div0,#Div0
supports,0,2,0,2,4,#Div0,0.0,#Div0
failture,0,0,1,0,1,0.0,#Div0,#Div0
wastful,0,0,0,1,1,#Div0,0.0,#Div0
sinch,0,0,1,0,1,0.0,#Div0,#Div0
truks,0,0,1,0,1,0.0,#Div0,#Div0
initelligent,0,0,1,0,1,0.0,#Div0,#Div0
miss,0,1,0,4,5,#Div0,0.0,#Div0
healthier,0,0,0,1,1,#Div0,0.0,#Div0
boring,0,15,1,0,16,0.0,#Div0,#Div0
bravery,0,0,0,1,1,#Div0,0.0,#Div0
cheating,0,1,0,3,4,#Div0,0.0,#Div0
pace,0,0,0,1,1,#Div0,0.0,#Div0
blast,0,0,0,1,1,#Div0,0.0,#Div0
collected,0,0,0,1,1,#Div0,0.0,#Div0
slower,0,0,0,1,1,#Div0,0.0,#Div0
pursue,0,0,0,2,2,#Div0,0.0,#Div0
used,0,37,0,2,39,#Div0,0.0,#Div0
advice,0,0,1,0,1,0.0,#Div0,#Div0
over,0,20,0,4,24,#Div0,0.0,#Div0
availible,0,0,0,1,1,#Div0,0.0,#Div0
conduce,0,0,0,1,1,#Div0,0.0,#Div0
render,0,1,1,0,2,0.0,#Div0,#Div0
floor,0,0,0,1,1,#Div0,0.0,#Div0
steal,0,1,1,0,2,0.0,#Div0,#Div0
obstacles,0,0,0,1,1,#Div0,0.0,#Div0
ignore,0,1,1,0,2,0.0,#Div0,#Div0
accelerating,0,0,0,1,1,#Div0,0.0,#Div0
marginal,1,0,0,0,1,1.0,1.0,1.0
example,0,137,0,1,138,#Div0,0.0,#Div0
employ,0,0,1,0,1,0.0,#Div0,#Div0
raised,0,1,0,1,2,#Div0,0.0,#Div0
connect,0,0,0,3,3,#Div0,0.0,#Div0
learning,0,51,1,0,52,0.0,#Div0,#Div0
biased,0,1,1,0,2,0.0,#Div0,#Div0
come,0,11,9,1,21,0.0,0.0,#Div0
standared,0,0,1,0,1,0.0,#Div0,#Div0
hurt,0,0,1,0,1,0.0,#Div0,#Div0
dedicates,0,0,0,1,1,#Div0,0.0,#Div0
depicted,0,0,0,1,1,#Div0,0.0,#Div0
indepth,1,0,0,0,1,1.0,1.0,1.0
pull,1,0,0,0,1,1.0,1.0,1.0
on,0,246,0,13,259,#Div0,0.0,#Div0
kill,0,0,0,1,1,#Div0,0.0,#Div0
the,0,2383,0,20,2403,#Div0,0.0,#Div0
messege,0,0,0,1,1,#Div0,0.0,#Div0
mentione,0,0,1,0,1,0.0,#Div0,#Div0
civil,0,1,1,0,2,0.0,#Div0,#Div0
sends,0,0,0,1,1,#Div0,0.0,#Div0
general,0,17,7,0,24,0.0,#Div0,#Div0
facing,0,0,0,2,2,#Div0,0.0,#Div0
tipical,0,0,1,0,1,0.0,#Div0,#Div0
it,0,565,0,1,566,#Div0,0.0,#Div0
atmosphere,0,2,0,1,3,#Div0,0.0,#Div0
avalible,0,0,0,1,1,#Div0,0.0,#Div0
individual,0,6,3,0,9,0.0,#Div0,#Div0
sacrifice,0,0,0,1,1,#Div0,0.0,#Div0
graphic,0,0,4,0,4,0.0,#Div0,#Div0
marketting,0,0,1,0,1,0.0,#Div0,#Div0
long,0,22,4,1,27,0.0,0.0,#Div0
natural,0,3,0,2,5,#Div0,0.0,#Div0
level,0,5,0,7,12,#Div0,0.0,#Div0
same,1,16,48,0,65,0.02040816326530612,1.0,0.039999999999999994
shallow,0,0,0,1,1,#Div0,0.0,#Div0
sometimes,0,28,1,0,29,0.0,#Div0,#Div0
gives,0,12,0,14,26,#Div0,0.0,#Div0
points,0,3,0,1,4,#Div0,0.0,#Div0
stop,1,4,3,0,8,0.25,1.0,0.4
trabeling,0,0,1,0,1,0.0,#Div0,#Div0
common,0,8,0,1,9,#Div0,0.0,#Div0
professional,0,1,4,0,5,0.0,#Div0,#Div0
greater,0,5,0,1,6,#Div0,0.0,#Div0
american,0,0,1,0,1,0.0,#Div0,#Div0
primises,0,0,0,1,1,#Div0,0.0,#Div0
find,0,33,14,7,54,0.0,0.0,#Div0
put,3,1,1,4,9,0.75,0.42857142857142855,0.5454545454545454
rule,0,1,0,1,2,#Div0,0.0,#Div0
overcome,2,0,0,1,3,1.0,0.6666666666666666,0.8
pushed,0,0,0,1,1,#Div0,0.0,#Div0
stage,0,3,0,9,12,#Div0,0.0,#Div0
brings,0,9,0,1,10,#Div0,0.0,#Div0
Regarding,0,0,1,0,1,0.0,#Div0,#Div0
defraud,0,0,1,0,1,0.0,#Div0,#Div0
cover,0,1,0,2,3,#Div0,0.0,#Div0
broad,48,0,0,8,56,1.0,0.8571428571428571,0.923076923076923
encouraging,0,0,1,0,1,0.0,#Div0,#Div0
unnatural,0,0,2,0,2,0.0,#Div0,#Div0
sacrificing,0,0,0,1,1,#Div0,0.0,#Div0
exploring,0,0,0,2,2,#Div0,0.0,#Div0
indivudual,0,0,1,0,1,0.0,#Div0,#Div0
figure,0,1,1,0,2,0.0,#Div0,#Div0
moves,0,1,0,1,2,#Div0,0.0,#Div0
elements,0,1,0,2,3,#Div0,0.0,#Div0
possitive,0,0,1,0,1,0.0,#Div0,#Div0
local,0,14,7,0,21,0.0,#Div0,#Div0
outburst,0,0,0,1,1,#Div0,0.0,#Div0
testing,0,1,1,0,2,0.0,#Div0,#Div0
new,0,202,9,3,214,0.0,0.0,#Div0
fake,1,0,0,0,1,1.0,1.0,1.0
non-profit,0,0,3,0,3,0.0,#Div0,#Div0
decide,0,6,5,0,11,0.0,#Div0,#Div0
Greenhouse,0,0,0,1,1,#Div0,0.0,#Div0
nominate,0,0,1,0,1,0.0,#Div0,#Div0
worth,0,1,0,1,2,#Div0,0.0,#Div0
humane,0,0,1,0,1,0.0,#Div0,#Div0
expectative,0,1,1,0,2,0.0,#Div0,#Div0
simulate,0,0,1,0,1,0.0,#Div0,#Div0
carrier,0,0,0,1,1,#Div0,0.0,#Div0
disabled,0,0,1,0,1,0.0,#Div0,#Div0
electric,0,5,1,0,6,0.0,#Div0,#Div0
n,0,0,1,0,1,0.0,#Div0,#Div0
dagerousness,0,0,0,1,1,#Div0,0.0,#Div0
Japanese,0,6,2,0,8,0.0,#Div0,#Div0
ruch,1,0,0,0,1,1.0,1.0,1.0
suffer,0,0,0,1,1,#Div0,0.0,#Div0
bilological,0,0,1,0,1,0.0,#Div0,#Div0
trabel,0,1,1,0,2,0.0,#Div0,#Div0
under,0,2,0,1,3,#Div0,0.0,#Div0
hundred,0,0,0,1,1,#Div0,0.0,#Div0
resist,0,0,0,1,1,#Div0,0.0,#Div0
episodes,0,0,0,1,1,#Div0,0.0,#Div0
avaliable,0,0,1,0,1,0.0,#Div0,#Div0
Using,0,2,1,0,3,0.0,#Div0,#Div0
rigid,0,0,0,1,1,#Div0,0.0,#Div0
authentic,0,0,1,0,1,0.0,#Div0,#Div0
lose,4,2,1,4,11,0.8,0.5,0.6153846153846154
confess,0,0,0,1,1,#Div0,0.0,#Div0
between,0,17,0,2,19,#Div0,0.0,#Div0
Speacializing,0,0,1,0,1,0.0,#Div0,#Div0
Helping,0,0,1,0,1,0.0,#Div0,#Div0
rare,0,0,0,1,1,#Div0,0.0,#Div0
devotng,1,0,0,0,1,1.0,1.0,1.0
inflate,1,0,0,0,1,1.0,1.0,1.0
re,0,3,5,0,8,0.0,#Div0,#Div0
point,0,24,2,4,30,0.0,0.0,#Div0
precious,1,1,0,1,3,1.0,0.5,0.6666666666666666
leave,0,5,1,0,6,0.0,#Div0,#Div0
coordinating,0,0,0,1,1,#Div0,0.0,#Div0
our,0,107,0,1,108,#Div0,0.0,#Div0
prsonal,0,0,1,0,1,0.0,#Div0,#Div0
Educational,0,0,1,0,1,0.0,#Div0,#Div0
lazy,0,3,1,0,4,0.0,#Div0,#Div0
increases,0,1,0,1,2,#Div0,0.0,#Div0
plane,0,3,1,0,4,0.0,#Div0,#Div0
withotut,0,0,1,0,1,0.0,#Div0,#Div0
high,0,19,3,2,24,0.0,0.0,#Div0
extract,0,0,0,1,1,#Div0,0.0,#Div0
advertise,0,3,2,0,5,0.0,#Div0,#Div0
disaster,0,1,0,2,3,#Div0,0.0,#Div0
middle,0,1,0,2,3,#Div0,0.0,#Div0
reach,6,1,0,9,16,1.0,0.4,0.5714285714285715
rewarded,0,0,0,1,1,#Div0,0.0,#Div0
parallel,1,0,0,0,1,1.0,1.0,1.0
powerfull,1,0,0,0,1,1.0,1.0,1.0
arrive,0,1,1,0,2,0.0,#Div0,#Div0
area,0,5,0,1,6,#Div0,0.0,#Div0
grow,5,4,1,5,15,0.8333333333333334,0.5,0.625
built,0,2,0,3,5,#Div0,0.0,#Div0
fruitful,0,0,0,1,1,#Div0,0.0,#Div0
energetic,0,2,1,0,3,0.0,#Div0,#Div0
primay,0,0,1,0,1,0.0,#Div0,#Div0
surrounded,0,1,0,1,2,#Div0,0.0,#Div0
works,0,16,0,1,17,#Div0,0.0,#Div0
trap,0,0,0,1,1,#Div0,0.0,#Div0
carries,0,0,0,1,1,#Div0,0.0,#Div0
advantages,0,13,0,1,14,#Div0,0.0,#Div0
Long,0,0,1,0,1,0.0,#Div0,#Div0
attract,2,0,0,3,5,1.0,0.4,0.5714285714285715
person,0,131,0,1,132,#Div0,0.0,#Div0
less,0,42,0,4,46,#Div0,0.0,#Div0
introduce,0,0,2,0,2,0.0,#Div0,#Div0
spikes,0,0,0,1,1,#Div0,0.0,#Div0
restrict,1,1,0,0,2,1.0,1.0,1.0
ather,0,0,1,0,1,0.0,#Div0,#Div0
improve,0,24,6,0,30,0.0,#Div0,#Div0
affective,0,0,1,0,1,0.0,#Div0,#Div0
grant,0,0,1,2,3,0.0,0.0,#Div0
leads,0,1,0,10,11,#Div0,0.0,#Div0
relax,1,0,1,0,2,0.5,1.0,0.6666666666666666
shift,1,0,0,0,1,1.0,1.0,1.0
talk,0,10,9,0,19,0.0,#Div0,#Div0
such,0,63,11,0,74,0.0,#Div0,#Div0
attachment,0,0,0,2,2,#Div0,0.0,#Div0
immidetaly,0,0,1,0,1,0.0,#Div0,#Div0
horizontal,0,0,0,1,1,#Div0,0.0,#Div0
going,0,55,0,3,58,#Div0,0.0,#Div0
beilive,0,1,2,0,3,0.0,#Div0,#Div0
admire,0,0,1,0,1,0.0,#Div0,#Div0
matured,0,0,1,0,1,0.0,#Div0,#Div0
selling,0,3,0,1,4,#Div0,0.0,#Div0
aproach,1,0,0,0,1,1.0,1.0,1.0
take,6,33,33,9,81,0.15384615384615385,0.4,0.2222222222222222
learn,0,64,33,0,97,0.0,#Div0,#Div0
down,0,4,0,2,6,#Div0,0.0,#Div0
rush,0,0,0,1,1,#Div0,0.0,#Div0
strong,2,1,0,16,19,1.0,0.1111111111111111,0.19999999999999998
strongly,0,2,0,13,15,#Div0,0.0,#Div0
don,0,2,1,0,3,0.0,#Div0,#Div0
freak,0,0,1,0,1,0.0,#Div0,#Div0
immerse,0,0,0,1,1,#Div0,0.0,#Div0
big,1,19,12,4,36,0.07692307692307693,0.2,0.1111111111111111
blocked,0,0,0,1,1,#Div0,0.0,#Div0
sorses,0,0,0,1,1,#Div0,0.0,#Div0
pop,0,0,0,1,1,#Div0,0.0,#Div0
saling,0,0,1,0,1,0.0,#Div0,#Div0
challange,0,0,0,1,1,#Div0,0.0,#Div0
official,0,2,1,0,3,0.0,#Div0,#Div0
there,0,232,1,0,233,0.0,#Div0,#Div0
tons,0,0,0,1,1,#Div0,0.0,#Div0
true,0,35,1,0,36,0.0,#Div0,#Div0
unsatisfied,0,0,1,0,1,0.0,#Div0,#Div0
actual,0,2,1,0,3,0.0,#Div0,#Div0
final,0,1,2,0,3,0.0,#Div0,#Div0
ve,0,1,5,0,6,0.0,#Div0,#Div0
sit,0,0,0,1,1,#Div0,0.0,#Div0
sources,0,3,0,2,5,#Div0,0.0,#Div0
univeristy,0,0,1,0,1,0.0,#Div0,#Div0
task,0,1,0,1,2,#Div0,0.0,#Div0
breakdown,0,0,0,1,1,#Div0,0.0,#Div0
grew,0,1,0,2,3,#Div0,0.0,#Div0
succeeed,0,0,1,0,1,0.0,#Div0,#Div0
crash,0,0,0,1,1,#Div0,0.0,#Div0
disaggree,0,0,1,0,1,0.0,#Div0,#Div0
depend,0,3,1,0,4,0.0,#Div0,#Div0
paving,0,0,0,1,1,#Div0,0.0,#Div0
flexiblly,0,0,0,2,2,#Div0,0.0,#Div0
Working,0,0,1,0,1,0.0,#Div0,#Div0
spots,0,1,0,1,2,#Div0,0.0,#Div0
explosion,0,0,0,1,1,#Div0,0.0,#Div0
mean,0,12,9,0,21,0.0,#Div0,#Div0
eaten,0,0,0,1,1,#Div0,0.0,#Div0
irresponsible,0,0,1,0,1,0.0,#Div0,#Div0
Thai,0,1,1,0,2,0.0,#Div0,#Div0
former,0,0,1,0,1,0.0,#Div0,#Div0
ony,0,0,1,0,1,0.0,#Div0,#Div0
sexteen,0,0,1,0,1,0.0,#Div0,#Div0
comes,0,10,0,2,12,#Div0,0.0,#Div0
sorrounds,0,0,0,1,1,#Div0,0.0,#Div0
cuold,0,0,1,0,1,0.0,#Div0,#Div0
losing,0,0,0,4,4,#Div0,0.0,#Div0
ladder,0,0,0,3,3,#Div0,0.0,#Div0
regardless,0,3,1,0,4,0.0,#Div0,#Div0
fundamental,0,1,0,1,2,#Div0,0.0,#Div0
launguge,0,1,1,0,2,0.0,#Div0,#Div0
aobut,0,0,1,0,1,0.0,#Div0,#Div0
awful,0,2,1,0,3,0.0,#Div0,#Div0
ditailed,0,0,1,0,1,0.0,#Div0,#Div0
means,0,29,0,1,30,#Div0,0.0,#Div0
gerenal,0,0,1,0,1,0.0,#Div0,#Div0
endless,0,0,0,1,1,#Div0,0.0,#Div0
elementery,0,0,1,0,1,0.0,#Div0,#Div0
dangerous,0,3,0,4,7,#Div0,0.0,#Div0
current,0,5,1,0,6,0.0,#Div0,#Div0
stupid,0,0,0,1,1,#Div0,0.0,#Div0
taking,0,24,0,6,30,#Div0,0.0,#Div0
system,0,8,0,2,10,#Div0,0.0,#Div0
haviing,0,0,1,0,1,0.0,#Div0,#Div0
realy,0,1,1,0,2,0.0,#Div0,#Div0
relay,1,0,0,1,2,1.0,0.5,0.6666666666666666
differenet,0,0,1,0,1,0.0,#Div0,#Div0
talking,0,8,0,2,10,#Div0,0.0,#Div0
fixing,0,0,0,1,1,#Div0,0.0,#Div0
Next,0,1,1,0,2,0.0,#Div0,#Div0
opened,0,0,0,1,1,#Div0,0.0,#Div0
drastic,0,0,1,0,1,0.0,#Div0,#Div0
stability,0,0,0,2,2,#Div0,0.0,#Div0
nearer,0,0,0,1,1,#Div0,0.0,#Div0
early,0,6,0,1,7,#Div0,0.0,#Div0
special,0,9,2,0,11,0.0,#Div0,#Div0
spot,0,0,0,1,1,#Div0,0.0,#Div0
broke,0,1,0,1,2,#Div0,0.0,#Div0
friend,0,24,1,0,25,0.0,#Div0,#Div0
thanks,0,1,1,0,2,0.0,#Div0,#Div0
manage,1,0,0,1,2,1.0,0.5,0.6666666666666666
experiments,0,0,0,1,1,#Div0,0.0,#Div0
jams,0,0,0,1,1,#Div0,0.0,#Div0
ceariative,0,0,1,0,1,0.0,#Div0,#Div0
convincing,0,2,2,0,4,0.0,#Div0,#Div0
Viceversa,0,1,1,0,2,0.0,#Div0,#Div0
Nowadays,0,13,1,0,14,0.0,#Div0,#Div0
perspectives,0,0,0,2,2,#Div0,0.0,#Div0
povide,0,0,1,0,1,0.0,#Div0,#Div0
e,0,1,1,0,2,0.0,#Div0,#Div0
utilize,0,0,1,0,1,0.0,#Div0,#Div0
require,1,5,1,0,7,0.5,1.0,0.6666666666666666
encourages,0,1,0,1,2,#Div0,0.0,#Div0
Limiting,0,0,1,0,1,0.0,#Div0,#Div0
cannnot,0,0,1,0,1,0.0,#Div0,#Div0
specilaized,0,0,1,0,1,0.0,#Div0,#Div0
attracted,0,0,0,1,1,#Div0,0.0,#Div0
inside,0,2,0,2,4,#Div0,0.0,#Div0
confines,0,0,0,1,1,#Div0,0.0,#Div0
conection,0,0,0,1,1,#Div0,0.0,#Div0
reveals,0,0,0,2,2,#Div0,0.0,#Div0
dreams,0,1,0,1,2,#Div0,0.0,#Div0
face,3,2,0,12,17,1.0,0.2,0.33333333333333337
alike,0,0,1,0,1,0.0,#Div0,#Div0
passions,0,0,0,1,1,#Div0,0.0,#Div0
stuffed,0,0,0,1,1,#Div0,0.0,#Div0
limits,0,1,0,3,4,#Div0,0.0,#Div0
disappear,1,2,1,0,4,0.5,1.0,0.6666666666666666
version,0,0,0,2,2,#Div0,0.0,#Div0
dragged,0,0,0,1,1,#Div0,0.0,#Div0
belive,0,1,4,0,5,0.0,#Div0,#Div0
gifted,0,0,0,1,1,#Div0,0.0,#Div0
base,0,0,0,4,4,#Div0,0.0,#Div0
forget,1,3,1,0,5,0.5,1.0,0.6666666666666666
support,7,3,3,13,26,0.7,0.35,0.4666666666666667
physiological,0,0,1,0,1,0.0,#Div0,#Div0
requieres,0,0,2,0,2,0.0,#Div0,#Div0
sum,0,1,6,0,7,0.0,#Div0,#Div0
a,0,1358,0,6,1364,#Div0,0.0,#Div0
after,0,49,0,2,51,#Div0,0.0,#Div0
specefic,0,0,1,0,1,0.0,#Div0,#Div0
exist,0,3,3,0,6,0.0,#Div0,#Div0
appeal,0,0,0,1,1,#Div0,0.0,#Div0
connector,0,0,0,1,1,#Div0,0.0,#Div0
nomal,0,0,1,0,1,0.0,#Div0,#Div0
finding,0,2,0,1,3,#Div0,0.0,#Div0
Is,0,2,3,0,5,0.0,#Div0,#Div0
ride,0,1,1,0,2,0.0,#Div0,#Div0
resolve,0,1,1,0,2,0.0,#Div0,#Div0
formed,0,0,0,1,1,#Div0,0.0,#Div0
high-speed,0,0,1,0,1,0.0,#Div0,#Div0
save,2,3,2,1,8,0.5,0.6666666666666666,0.5714285714285715
right,0,19,4,0,23,0.0,#Div0,#Div0
obtained,0,0,0,1,1,#Div0,0.0,#Div0
main,0,14,3,0,17,0.0,#Div0,#Div0
money,0,60,0,1,61,#Div0,0.0,#Div0
positoin,0,0,0,1,1,#Div0,0.0,#Div0
histrical,0,0,2,0,2,0.0,#Div0,#Div0
shy,0,0,1,0,1,0.0,#Div0,#Div0
vast,0,1,0,2,3,#Div0,0.0,#Div0
prospective,0,1,1,0,2,0.0,#Div0,#Div0
Undrestanding,0,0,1,0,1,0.0,#Div0,#Div0
cosmetic,0,1,5,0,6,0.0,#Div0,#Div0
handy,0,0,0,2,2,#Div0,0.0,#Div0
helpful,0,9,1,0,10,0.0,#Div0,#Div0
nessessary,0,0,2,0,2,0.0,#Div0,#Div0
carachterize,0,0,1,0,1,0.0,#Div0,#Div0
aiming,0,0,0,1,1,#Div0,0.0,#Div0
develop,1,7,0,4,12,1.0,0.2,0.33333333333333337
use,0,64,24,3,91,0.0,0.0,#Div0
eat,0,7,2,0,9,0.0,#Div0,#Div0
touch,0,1,0,3,4,#Div0,0.0,#Div0
expensive,0,18,2,0,20,0.0,#Div0,#Div0
acquired,0,3,0,1,4,#Div0,0.0,#Div0
explain,0,10,7,0,17,0.0,#Div0,#Div0
chase,1,0,0,0,1,1.0,1.0,1.0
deep,3,0,0,3,6,1.0,0.5,0.6666666666666666
rejected,0,2,0,1,3,#Div0,0.0,#Div0
Leaving,0,0,1,0,1,0.0,#Div0,#Div0
stars,0,0,0,1,1,#Div0,0.0,#Div0
own,1,15,41,0,57,0.023809523809523808,1.0,0.046511627906976744
fit,0,0,0,2,2,#Div0,0.0,#Div0
firmly,0,0,0,1,1,#Div0,0.0,#Div0
convenced,0,1,2,0,3,0.0,#Div0,#Div0
phase,0,0,0,2,2,#Div0,0.0,#Div0
strict,0,0,0,1,1,#Div0,0.0,#Div0
foreing,0,0,1,0,1,0.0,#Div0,#Div0
climb,1,1,0,0,2,1.0,1.0,1.0
mind,0,28,1,0,29,0.0,#Div0,#Div0
mnemonic,0,0,1,0,1,0.0,#Div0,#Div0
understaning,0,0,1,0,1,0.0,#Div0,#Div0
keeping,0,2,0,1,3,#Div0,0.0,#Div0
grown,0,1,0,2,3,#Div0,0.0,#Div0
population,0,17,0,1,18,#Div0,0.0,#Div0
mainstream,1,0,0,0,1,1.0,1.0,1.0
discard,0,0,0,1,1,#Div0,0.0,#Div0
dots,0,0,0,1,1,#Div0,0.0,#Div0
based,0,5,0,10,15,#Div0,0.0,#Div0
knowledge,0,148,2,0,150,0.0,#Div0,#Div0
Theorical,0,0,1,0,1,0.0,#Div0,#Div0
concentration,0,0,0,1,1,#Div0,0.0,#Div0
absurde,0,0,1,0,1,0.0,#Div0,#Div0
buy,1,37,5,0,43,0.16666666666666666,1.0,0.2857142857142857
give,19,9,19,16,63,0.5,0.5428571428571428,0.5205479452054795
Strongly,0,0,0,1,1,#Div0,0.0,#Div0
structure,0,1,0,2,3,#Div0,0.0,#Div0
image,0,2,0,6,8,#Div0,0.0,#Div0
trust,0,6,1,0,7,0.0,#Div0,#Div0
suffuring,0,0,0,1,1,#Div0,0.0,#Div0
deeper,0,0,0,5,5,#Div0,0.0,#Div0
toshiba,0,1,3,0,4,0.0,#Div0,#Div0
remain,1,1,1,1,4,0.5,0.5,0.5
econimical,0,0,1,0,1,0.0,#Div0,#Div0
back,0,7,0,3,10,#Div0,0.0,#Div0
controversial,0,0,1,0,1,0.0,#Div0,#Div0
enforce,0,0,1,0,1,0.0,#Div0,#Div0
growing,0,3,0,7,10,#Div0,0.0,#Div0
comforatable,0,0,0,1,1,#Div0,0.0,#Div0
industrial,0,1,1,0,2,0.0,#Div0,#Div0
worldwide-best-seller,0,0,1,0,1,0.0,#Div0,#Div0
Getting,0,0,0,1,1,#Div0,0.0,#Div0
supporting,0,0,0,1,1,#Div0,0.0,#Div0
flexibility,0,0,0,2,2,#Div0,0.0,#Div0
hurm,1,0,0,0,1,1.0,1.0,1.0
dicover,0,0,0,1,1,#Div0,0.0,#Div0
move,1,9,5,0,15,0.16666666666666666,1.0,0.2857142857142857
rising,0,0,0,1,1,#Div0,0.0,#Div0
public,0,19,2,0,21,0.0,#Div0,#Div0
changed,0,7,0,1,8,#Div0,0.0,#Div0
builds,0,0,0,2,2,#Div0,0.0,#Div0
studied,0,17,1,0,18,0.0,#Div0,#Div0
disageed,0,0,1,0,1,0.0,#Div0,#Div0
rules,0,2,0,1,3,#Div0,0.0,#Div0
substained,0,0,0,1,1,#Div0,0.0,#Div0
spirit,0,0,0,1,1,#Div0,0.0,#Div0
clear,1,2,1,6,10,0.5,0.14285714285714285,0.22222222222222224
flower,0,0,0,1,1,#Div0,0.0,#Div0
kept,0,1,0,1,2,#Div0,0.0,#Div0
doors,0,1,0,1,2,#Div0,0.0,#Div0
encourage,0,1,2,0,3,0.0,#Div0,#Div0
blame,0,0,1,0,1,0.0,#Div0,#Div0
with,0,428,0,2,430,#Div0,0.0,#Div0
hunger,0,0,0,1,1,#Div0,0.0,#Div0
secured,0,0,0,1,1,#Div0,0.0,#Div0
glass-making,0,0,1,0,1,0.0,#Div0,#Div0
strengthen,0,0,0,1,1,#Div0,0.0,#Div0
stricted,0,0,0,1,1,#Div0,0.0,#Div0
twentieth,0,1,2,0,3,0.0,#Div0,#Div0
evolved,0,0,0,1,1,#Div0,0.0,#Div0
stay,0,5,5,1,11,0.0,0.0,#Div0
visit,0,11,8,0,19,0.0,#Div0,#Div0
12-hour,0,0,2,0,2,0.0,#Div0,#Div0
promoting,0,2,0,1,3,#Div0,0.0,#Div0
power,0,0,0,2,2,#Div0,0.0,#Div0
surface,0,1,0,1,2,#Div0,0.0,#Div0
deep-snow,0,0,1,0,1,0.0,#Div0,#Div0
forward,0,0,0,2,2,#Div0,0.0,#Div0
stronger,0,1,0,2,3,#Div0,0.0,#Div0
Folowing,0,0,1,0,1,0.0,#Div0,#Div0
basing,0,0,0,1,1,#Div0,0.0,#Div0
accessble,0,0,0,1,1,#Div0,0.0,#Div0
wish,0,3,1,0,4,0.0,#Div0,#Div0
loosing,0,0,0,1,1,#Div0,0.0,#Div0
stongly,0,0,0,2,2,#Div0,0.0,#Div0
tour,0,102,24,0,126,0.0,#Div0,#Div0
runs,0,0,0,1,1,#Div0,0.0,#Div0
entered,0,1,0,1,2,#Div0,0.0,#Div0
look,2,16,10,3,31,0.16666666666666666,0.4,0.23529411764705882
declare,0,0,1,0,1,0.0,#Div0,#Div0
foretasted,1,0,0,0,1,1.0,1.0,1.0
sixty,0,0,1,0,1,0.0,#Div0,#Div0
schocking,1,0,0,0,1,1.0,1.0,1.0
brought,0,0,0,2,2,#Div0,0.0,#Div0
exelent,0,0,1,0,1,0.0,#Div0,#Div0
goes,0,7,0,1,8,#Div0,0.0,#Div0
peronal,0,0,1,0,1,0.0,#Div0,#Div0
distract,0,0,0,1,1,#Div0,0.0,#Div0
profit,0,1,1,0,2,0.0,#Div0,#Div0
fouty,0,0,1,0,1,0.0,#Div0,#Div0
reserve,0,0,1,0,1,0.0,#Div0,#Div0
respect,1,5,2,1,9,0.3333333333333333,0.5,0.4
filling,0,0,0,1,1,#Div0,0.0,#Div0
organize,0,5,6,0,11,0.0,#Div0,#Div0
pay,0,5,3,5,13,0.0,0.0,#Div0
Concluding,0,0,1,0,1,0.0,#Div0,#Div0
needy,0,1,3,0,4,0.0,#Div0,#Div0
piece,0,0,0,1,1,#Div0,0.0,#Div0
acknowledged,0,0,1,0,1,0.0,#Div0,#Div0
putting,0,0,0,2,2,#Div0,0.0,#Div0
share,0,6,0,2,8,#Div0,0.0,#Div0
enjoyable,0,4,3,0,7,0.0,#Div0,#Div0
crowded,0,2,1,0,3,0.0,#Div0,#Div0
Red,0,1,1,0,2,0.0,#Div0,#Div0
spent,0,1,0,3,4,#Div0,0.0,#Div0
secure,0,0,0,1,1,#Div0,0.0,#Div0
relevant,0,0,1,0,1,0.0,#Div0,#Div0
lost,0,10,0,2,12,#Div0,0.0,#Div0
spending,0,2,0,5,7,#Div0,0.0,#Div0
friendly,0,1,0,1,2,#Div0,0.0,#Div0
previous,0,1,1,0,2,0.0,#Div0,#Div0
pursuing,0,0,0,1,1,#Div0,0.0,#Div0
advertisement,0,63,5,0,68,0.0,#Div0,#Div0
wider,0,0,0,4,4,#Div0,0.0,#Div0
fully,0,2,0,6,8,#Div0,0.0,#Div0
drink,0,3,1,0,4,0.0,#Div0,#Div0
advancement,0,0,0,4,4,#Div0,0.0,#Div0
wipe,0,0,1,0,1,0.0,#Div0,#Div0
undermine,0,0,1,1,2,0.0,0.0,#Div0
hiding,0,0,0,1,1,#Div0,0.0,#Div0
let,0,5,4,0,9,0.0,#Div0,#Div0
contractcting,0,0,1,0,1,0.0,#Div0,#Div0
colder,0,0,0,1,1,#Div0,0.0,#Div0
rely,1,0,0,2,3,1.0,0.3333333333333333,0.5
old,0,45,6,0,51,0.0,#Div0,#Div0
carry,1,0,0,1,2,1.0,0.5,0.6666666666666666
intencity,0,0,0,2,2,#Div0,0.0,#Div0
wasting,0,0,0,2,2,#Div0,0.0,#Div0
perspective,0,2,0,1,3,#Div0,0.0,#Div0
seem,0,26,10,0,36,0.0,#Div0,#Div0
long-distance,0,0,1,0,1,0.0,#Div0,#Div0
complement,0,0,0,1,1,#Div0,0.0,#Div0
everyting,0,0,1,0,1,0.0,#Div0,#Div0
environment-friendly,0,0,1,0,1,0.0,#Div0,#Div0
divided,0,0,0,1,1,#Div0,0.0,#Div0
anew,0,1,1,0,2,0.0,#Div0,#Div0
lead,5,3,1,9,18,0.8333333333333334,0.35714285714285715,0.5
followed,0,2,0,1,3,#Div0,0.0,#Div0
throwing,0,0,0,1,1,#Div0,0.0,#Div0
concentrate,1,0,1,0,2,0.5,1.0,0.6666666666666666
catastrophic,1,0,0,0,1,1.0,1.0,1.0
above,0,19,1,0,20,0.0,#Div0,#Div0
Broad,0,0,0,1,1,#Div0,0.0,#Div0
useful,0,26,0,1,27,#Div0,0.0,#Div0
prevent,0,3,2,0,5,0.0,#Div0,#Div0
fullfill,0,0,1,0,1,0.0,#Div0,#Div0
price,0,13,0,1,14,#Div0,0.0,#Div0
Spikes,0,0,0,1,1,#Div0,0.0,#Div0
pass,1,1,0,0,2,1.0,1.0,1.0
Reducing,0,0,1,0,1,0.0,#Div0,#Div0
private,0,8,1,1,10,0.0,0.0,#Div0
referenced,0,0,1,0,1,0.0,#Div0,#Div0
passed,0,0,0,1,1,#Div0,0.0,#Div0
past,0,16,3,0,19,0.0,#Div0,#Div0
twenty,0,40,8,0,48,0.0,#Div0,#Div0
continue,0,4,4,0,8,0.0,#Div0,#Div0
i,0,131,12,0,143,0.0,#Div0,#Div0
basic,0,2,2,5,9,0.0,0.0,#Div0
Academic,0,0,1,0,1,0.0,#Div0,#Div0
proplems,0,0,1,0,1,0.0,#Div0,#Div0
famous,0,10,1,0,11,0.0,#Div0,#Div0
retributed,0,0,1,0,1,0.0,#Div0,#Div0
travel,0,54,30,0,84,0.0,#Div0,#Div0
lerning,0,0,2,0,2,0.0,#Div0,#Div0
succeed,0,12,4,0,16,0.0,#Div0,#Div0
animal,0,0,1,0,1,0.0,#Div0,#Div0
feed,0,1,0,1,2,#Div0,0.0,#Div0
upon,0,5,0,1,6,#Div0,0.0,#Div0
abandon,1,0,0,1,2,1.0,0.5,0.6666666666666666
attend,0,5,1,0,6,0.0,#Div0,#Div0
laptop,0,2,1,0,3,0.0,#Div0,#Div0
different,0,85,15,0,100,0.0,#Div0,#Div0
succesesful,0,0,1,0,1,0.0,#Div0,#Div0
shrugged,0,0,0,1,1,#Div0,0.0,#Div0
shiny,0,0,1,1,2,0.0,0.0,#Div0
limit,1,1,1,3,6,0.5,0.25,0.3333333333333333
reap,0,0,0,1,1,#Div0,0.0,#Div0
evaluate,0,0,1,0,1,0.0,#Div0,#Div0
join,0,6,2,0,8,0.0,#Div0,#Div0
unstable,0,0,0,1,1,#Div0,0.0,#Div0
carried,0,0,0,1,1,#Div0,0.0,#Div0
enjoing,0,2,1,0,3,0.0,#Div0,#Div0
keep,4,13,5,5,27,0.4444444444444444,0.4444444444444444,0.4444444444444444
political,0,3,1,0,4,0.0,#Div0,#Div0
compete,1,0,1,0,2,0.5,1.0,0.6666666666666666
touched,0,0,0,2,2,#Div0,0.0,#Div0
master,0,0,0,1,1,#Div0,0.0,#Div0
contributes,0,0,0,1,1,#Div0,0.0,#Div0
array,0,0,0,2,2,#Div0,0.0,#Div0
play,0,2,3,1,6,0.0,0.0,#Div0
tomorrow,0,0,0,2,2,#Div0,0.0,#Div0
increasing,0,17,0,1,18,#Div0,0.0,#Div0
Suppose,0,0,1,0,1,0.0,#Div0,#Div0
dislike,0,1,2,0,3,0.0,#Div0,#Div0
cool,0,2,0,1,3,#Div0,0.0,#Div0
tones,0,0,0,1,1,#Div0,0.0,#Div0
access,0,1,0,2,3,#Div0,0.0,#Div0
shows,0,11,0,2,13,#Div0,0.0,#Div0
actractivity,0,0,0,1,1,#Div0,0.0,#Div0
spacified,0,0,1,0,1,0.0,#Div0,#Div0
conclude,0,3,2,0,5,0.0,#Div0,#Div0
read,0,5,8,0,13,0.0,#Div0,#Div0
leaving,0,2,0,2,4,#Div0,0.0,#Div0
Direct,0,0,1,0,1,0.0,#Div0,#Div0
want,0,51,38,0,89,0.0,#Div0,#Div0
rich,0,5,0,3,8,#Div0,0.0,#Div0
hang,1,0,0,0,1,1.0,1.0,1.0
light,0,3,0,2,5,#Div0,0.0,#Div0
certain,0,17,3,0,20,0.0,#Div0,#Div0
sick,0,1,1,0,2,0.0,#Div0,#Div0
incredibile,0,0,1,0,1,0.0,#Div0,#Div0
need,0,53,30,1,84,0.0,0.0,#Div0
under-developed,0,0,1,0,1,0.0,#Div0,#Div0
picturelize,0,0,0,1,1,#Div0,0.0,#Div0
exposed,0,0,0,1,1,#Div0,0.0,#Div0
enemys,0,0,0,1,1,#Div0,0.0,#Div0
journey,0,6,0,2,8,#Div0,0.0,#Div0
cutting,0,0,0,1,1,#Div0,0.0,#Div0
environment,0,14,0,1,15,#Div0,0.0,#Div0
comfetable,1,0,1,0,2,0.5,1.0,0.6666666666666666
invent,0,0,1,0,1,0.0,#Div0,#Div0
pains,0,0,0,1,1,#Div0,0.0,#Div0
advancing,0,0,0,1,1,#Div0,0.0,#Div0
alotof,0,0,1,0,1,0.0,#Div0,#Div0
further,0,1,2,0,3,0.0,#Div0,#Div0
Studying,0,1,1,0,2,0.0,#Div0,#Div0
chain,0,0,0,2,2,#Div0,0.0,#Div0
allow,0,6,2,0,8,0.0,#Div0,#Div0
travell,0,0,1,0,1,0.0,#Div0,#Div0
repeat,0,2,1,0,3,0.0,#Div0,#Div0
refines,0,0,0,1,1,#Div0,0.0,#Div0
conduct,0,0,0,1,1,#Div0,0.0,#Div0
Given,0,0,1,0,1,0.0,#Div0,#Div0
ways,0,24,0,2,26,#Div0,0.0,#Div0
derives,0,0,0,1,1,#Div0,0.0,#Div0
remember,0,11,8,0,19,0.0,#Div0,#Div0
prefe,0,0,1,0,1,0.0,#Div0,#Div0
case,0,27,0,1,28,#Div0,0.0,#Div0
museums,0,2,1,0,3,0.0,#Div0,#Div0
tells,0,5,0,1,6,#Div0,0.0,#Div0
confortable,0,0,0,1,1,#Div0,0.0,#Div0
make,2,95,60,1,158,0.03225806451612903,0.6666666666666666,0.06153846153846154
subject,0,90,4,0,94,0.0,#Div0,#Div0
spread-out,1,0,0,0,1,1.0,1.0,1.0
enlarge,1,0,0,1,2,1.0,0.5,0.6666666666666666
upcoming,0,0,1,0,1,0.0,#Div0,#Div0
Resulting,0,0,1,0,1,0.0,#Div0,#Div0
pluck,1,0,0,0,1,1.0,1.0,1.0
importan,0,0,1,0,1,0.0,#Div0,#Div0
famouse,0,1,1,0,2,0.0,#Div0,#Div0
better,0,130,1,0,131,0.0,#Div0,#Div0
win,1,0,0,0,1,1.0,1.0,1.0
educational,0,2,1,0,3,0.0,#Div0,#Div0
succesful,0,1,1,0,2,0.0,#Div0,#Div0
Talking,0,0,1,0,1,0.0,#Div0,#Div0
bare,0,0,0,1,1,#Div0,0.0,#Div0
prized,0,0,0,1,1,#Div0,0.0,#Div0
cant,0,1,1,0,2,0.0,#Div0,#Div0
reward,0,0,0,1,1,#Div0,0.0,#Div0
available,4,11,1,0,16,0.8,1.0,0.888888888888889
answer,0,17,2,0,19,0.0,#Div0,#Div0
pepole,0,4,1,0,5,0.0,#Div0,#Div0
visibility,0,0,0,2,2,#Div0,0.0,#Div0
suport,0,0,0,1,1,#Div0,0.0,#Div0
surprising,0,0,1,0,1,0.0,#Div0,#Div0
rice,0,0,1,0,1,0.0,#Div0,#Div0
20th,0,0,1,0,1,0.0,#Div0,#Div0
repsreesnted,0,0,1,0,1,0.0,#Div0,#Div0
struggling,0,0,0,1,1,#Div0,0.0,#Div0
hire,0,1,2,0,3,0.0,#Div0,#Div0
Have,0,2,1,0,3,0.0,#Div0,#Div0
shier,0,0,0,1,1,#Div0,0.0,#Div0
culural,0,0,1,0,1,0.0,#Div0,#Div0
willing,0,9,0,1,10,#Div0,0.0,#Div0
estimated,0,0,1,0,1,0.0,#Div0,#Div0
forces,0,2,0,1,3,#Div0,0.0,#Div0
somr,0,0,1,0,1,0.0,#Div0,#Div0
NHS,0,1,1,0,2,0.0,#Div0,#Div0
follow,3,0,0,9,12,1.0,0.25,0.4
theyr,0,1,1,0,2,0.0,#Div0,#Div0
Last,0,4,2,0,6,0.0,#Div0,#Div0
so-called,0,1,1,0,2,0.0,#Div0,#Div0
boundaries,0,0,0,1,1,#Div0,0.0,#Div0
search,1,5,1,0,7,0.5,1.0,0.6666666666666666
growth,0,6,0,4,10,#Div0,0.0,#Div0
untrustable,0,0,1,0,1,0.0,#Div0,#Div0
activate,0,0,0,1,1,#Div0,0.0,#Div0
brag,0,0,1,0,1,0.0,#Div0,#Div0
frequent,0,0,1,0,1,0.0,#Div0,#Div0
offer,1,1,0,2,4,1.0,0.3333333333333333,0.5
Analyzing,0,0,1,0,1,0.0,#Div0,#Div0
intelligent,0,1,1,0,2,0.0,#Div0,#Div0
sophisticated,0,1,2,0,3,0.0,#Div0,#Div0
adn,0,0,1,0,1,0.0,#Div0,#Div0
pick,1,0,0,1,2,1.0,0.5,0.6666666666666666
spaces,0,0,0,1,1,#Div0,0.0,#Div0
stand,2,1,0,0,3,1.0,1.0,1.0
practicable,0,0,1,0,1,0.0,#Div0,#Div0
onece,0,0,1,0,1,0.0,#Div0,#Div0
whit,0,0,1,0,1,0.0,#Div0,#Div0
hidden,2,0,0,0,2,1.0,1.0,1.0
speacialize,0,0,1,0,1,0.0,#Div0,#Div0
surve,0,0,0,1,1,#Div0,0.0,#Div0
s,0,68,59,0,127,0.0,#Div0,#Div0
destroying,0,1,0,1,2,#Div0,0.0,#Div0
sociological,0,0,1,0,1,0.0,#Div0,#Div0
by,0,259,0,3,262,#Div0,0.0,#Div0
conception,0,0,0,1,1,#Div0,0.0,#Div0
isolation,0,0,1,0,1,0.0,#Div0,#Div0
wide,4,1,0,6,11,1.0,0.4,0.5714285714285715
evry,0,1,2,0,3,0.0,#Div0,#Div0
comphrehending,0,0,1,0,1,0.0,#Div0,#Div0
school-time,0,0,1,0,1,0.0,#Div0,#Div0
gave,0,6,0,3,9,#Div0,0.0,#Div0
major,0,15,1,0,16,0.0,#Div0,#Div0
out,0,46,0,9,55,#Div0,0.0,#Div0
pictures,0,1,0,1,2,#Div0,0.0,#Div0
division,0,3,0,1,4,#Div0,0.0,#Div0
daily,0,5,1,0,6,0.0,#Div0,#Div0
large,0,4,2,0,6,0.0,#Div0,#Div0
avoided,0,2,0,1,3,#Div0,0.0,#Div0
fields,0,8,0,3,11,#Div0,0.0,#Div0
ofren,0,0,1,0,1,0.0,#Div0,#Div0
spreaded,0,0,0,1,1,#Div0,0.0,#Div0
approach,0,1,0,8,9,#Div0,0.0,#Div0
Passing,0,0,1,0,1,0.0,#Div0,#Div0
messages,0,0,0,1,1,#Div0,0.0,#Div0
realize,0,3,4,0,7,0.0,#Div0,#Div0
devices,0,1,0,1,2,#Div0,0.0,#Div0
working,0,31,2,1,34,0.0,0.0,#Div0
inter,0,1,3,0,4,0.0,#Div0,#Div0
triyng,0,0,1,0,1,0.0,#Div0,#Div0
shed,0,0,0,1,1,#Div0,0.0,#Div0
vibrant,0,0,0,1,1,#Div0,0.0,#Div0
drop,1,0,0,1,2,1.0,0.5,0.6666666666666666
particular,0,20,2,0,22,0.0,#Div0,#Div0
message,0,1,0,1,2,#Div0,0.0,#Div0
ode,0,0,0,1,1,#Div0,0.0,#Div0
frozen,0,1,1,0,2,0.0,#Div0,#Div0
specialized,0,17,12,0,29,0.0,#Div0,#Div0
legend,0,0,0,1,1,#Div0,0.0,#Div0
leading,0,0,0,2,2,#Div0,0.0,#Div0
equal,0,0,1,0,1,0.0,#Div0,#Div0
young,0,32,181,0,213,0.0,#Div0,#Div0
legacy,0,0,0,1,1,#Div0,0.0,#Div0
bonds,0,0,0,1,1,#Div0,0.0,#Div0
financial,0,8,1,0,9,0.0,#Div0,#Div0
walk,0,6,2,0,8,0.0,#Div0,#Div0
stages,0,0,0,2,2,#Div0,0.0,#Div0
Young,0,12,2,0,14,0.0,#Div0,#Div0
adays,0,1,2,0,3,0.0,#Div0,#Div0
reflects,0,0,0,1,1,#Div0,0.0,#Div0
psycholgical,0,0,1,0,1,0.0,#Div0,#Div0
life,0,243,0,1,244,#Div0,0.0,#Div0
spends,0,1,0,2,3,#Div0,0.0,#Div0
came,0,7,0,1,8,#Div0,0.0,#Div0
add,1,1,0,2,4,1.0,0.3333333333333333,0.5
difficult,0,30,0,1,31,#Div0,0.0,#Div0
Compared,0,0,1,0,1,0.0,#Div0,#Div0
successful,0,67,16,0,83,0.0,#Div0,#Div0
60-years-old,0,0,1,0,1,0.0,#Div0,#Div0
handling,0,0,0,2,2,#Div0,0.0,#Div0
know,0,71,40,0,111,0.0,#Div0,#Div0
pearsonal,0,0,1,0,1,0.0,#Div0,#Div0
consume,0,0,1,2,3,0.0,0.0,#Div0
homeless,0,0,1,0,1,0.0,#Div0,#Div0
serious,0,4,0,1,5,#Div0,0.0,#Div0
higher,0,7,0,4,11,#Div0,0.0,#Div0
dominated,0,0,0,1,1,#Div0,0.0,#Div0
knolege,0,0,1,0,1,0.0,#Div0,#Div0
relying,0,0,0,1,1,#Div0,0.0,#Div0
othere,0,0,1,0,1,0.0,#Div0,#Div0
besic,0,0,0,1,1,#Div0,0.0,#Div0
surround,1,0,0,0,1,1.0,1.0,1.0
plannning,0,0,1,0,1,0.0,#Div0,#Div0
gulf,0,0,1,0,1,0.0,#Div0,#Div0
repared,0,0,0,1,1,#Div0,0.0,#Div0
unlimited,0,0,0,1,1,#Div0,0.0,#Div0
animals,0,3,0,1,4,#Div0,0.0,#Div0
contribut,0,0,0,1,1,#Div0,0.0,#Div0
fail,0,0,2,0,2,0.0,#Div0,#Div0
saved,0,2,0,1,3,#Div0,0.0,#Div0
horrifying,0,0,0,1,1,#Div0,0.0,#Div0
politic,0,1,1,0,2,0.0,#Div0,#Div0
conciliating,0,0,0,1,1,#Div0,0.0,#Div0
strenght,1,0,0,0,1,1.0,1.0,1.0
everyday,0,15,4,0,19,0.0,#Div0,#Div0
fifty,0,0,2,0,2,0.0,#Div0,#Div0
fancy,0,1,1,0,2,0.0,#Div0,#Div0
ruining,0,0,0,4,4,#Div0,0.0,#Div0
gather,0,0,1,2,3,0.0,0.0,#Div0
basical,0,0,2,0,2,0.0,#Div0,#Div0
experience,0,51,4,0,55,0.0,#Div0,#Div0
proportion,0,0,0,1,1,#Div0,0.0,#Div0
defined,1,0,0,0,1,1.0,1.0,1.0
bother,0,1,1,0,2,0.0,#Div0,#Div0
contemporary,0,2,1,0,3,0.0,#Div0,#Div0
deely,0,0,0,1,1,#Div0,0.0,#Div0
demands,0,2,0,1,3,#Div0,0.0,#Div0
succesfull,0,0,2,0,2,0.0,#Div0,#Div0
open,2,1,0,8,11,1.0,0.2,0.33333333333333337
nature,0,3,0,1,4,#Div0,0.0,#Div0
underlined,0,0,0,1,1,#Div0,0.0,#Div0
receive,0,2,1,1,4,0.0,0.0,#Div0
behind,0,1,0,6,7,#Div0,0.0,#Div0
forbidden,0,0,0,1,1,#Div0,0.0,#Div0
Having,0,2,3,0,5,0.0,#Div0,#Div0
invest,0,2,0,1,3,#Div0,0.0,#Div0
relied,0,0,0,1,1,#Div0,0.0,#Div0
Reaching,1,0,0,0,1,1.0,1.0,1.0
incresing,0,1,1,0,2,0.0,#Div0,#Div0
personal,0,28,2,0,30,0.0,#Div0,#Div0
blieve,0,0,1,0,1,0.0,#Div0,#Div0
extra,2,1,1,0,4,0.6666666666666666,1.0,0.8
balanced,0,0,0,1,1,#Div0,0.0,#Div0
foreign,0,0,8,0,8,0.0,#Div0,#Div0
discuss,0,1,3,0,4,0.0,#Div0,#Div0
felt,0,4,2,1,7,0.0,0.0,#Div0
external,0,0,2,0,2,0.0,#Div0,#Div0
pursued,0,0,0,1,1,#Div0,0.0,#Div0
mundane,0,0,1,0,1,0.0,#Div0,#Div0
diagree,0,0,1,0,1,0.0,#Div0,#Div0
work,1,81,16,3,101,0.058823529411764705,0.25,0.09523809523809523
multiply,0,0,1,1,2,0.0,0.0,#Div0
strainge,0,0,1,0,1,0.0,#Div0,#Div0
Few,0,0,1,0,1,0.0,#Div0,#Div0
loose,1,0,1,1,3,0.5,0.5,0.5
have,30,250,251,42,573,0.10676156583629894,0.4166666666666667,0.16997167138810199
shine,1,0,0,1,2,1.0,0.5,0.6666666666666666
overall,0,1,1,0,2,0.0,#Div0,#Div0
consider,0,6,6,0,12,0.0,#Div0,#Div0
majority,0,1,0,1,2,#Div0,0.0,#Div0
warmth,0,0,0,1,1,#Div0,0.0,#Div0
brrelliant,0,0,1,0,1,0.0,#Div0,#Div0
risky,0,5,10,0,15,0.0,#Div0,#Div0
familiar,0,2,0,1,3,#Div0,0.0,#Div0
unfamilitar,0,0,1,0,1,0.0,#Div0,#Div0
directed,0,0,0,2,2,#Div0,0.0,#Div0
starting,0,2,0,1,3,#Div0,0.0,#Div0
trials,0,0,0,1,1,#Div0,0.0,#Div0
schedule,0,9,1,0,10,0.0,#Div0,#Div0
accquire,0,0,0,1,1,#Div0,0.0,#Div0
wealthy,0,0,1,0,1,0.0,#Div0,#Div0
exaggerate,0,0,1,0,1,0.0,#Div0,#Div0
economic,0,6,1,0,7,0.0,#Div0,#Div0
focalized,1,0,0,0,1,1.0,1.0,1.0
obtain,1,3,1,4,9,0.5,0.2,0.28571428571428575
end,1,8,1,1,11,0.5,0.5,0.5
core,0,1,0,3,4,#Div0,0.0,#Div0
lens,0,0,0,1,1,#Div0,0.0,#Div0
intresting,0,2,1,0,3,0.0,#Div0,#Div0
ethinic,0,0,1,0,1,0.0,#Div0,#Div0
deriving,0,0,0,2,2,#Div0,0.0,#Div0
defended,0,0,0,1,1,#Div0,0.0,#Div0
youg,0,0,1,0,1,0.0,#Div0,#Div0
aid,0,0,1,0,1,0.0,#Div0,#Div0
represent,0,1,1,0,2,0.0,#Div0,#Div0
keys,0,0,0,1,1,#Div0,0.0,#Div0
passive,1,0,0,0,1,1.0,1.0,1.0
flying,0,0,0,1,1,#Div0,0.0,#Div0
dream,0,0,0,5,5,#Div0,0.0,#Div0
heshe,0,12,1,0,13,0.0,#Div0,#Div0
withot,0,0,1,0,1,0.0,#Div0,#Div0
much,0,91,25,0,116,0.0,#Div0,#Div0
habbits,0,0,0,1,1,#Div0,0.0,#Div0
appealing,0,0,0,2,2,#Div0,0.0,#Div0
change,0,32,10,0,42,0.0,#Div0,#Div0
discover,2,2,0,3,7,1.0,0.4,0.5714285714285715
deeply,0,0,0,8,8,#Div0,0.0,#Div0
symbol,0,0,0,2,2,#Div0,0.0,#Div0
leg,0,0,0,1,1,#Div0,0.0,#Div0
socialize,0,0,2,0,2,0.0,#Div0,#Div0
world,0,70,0,8,78,#Div0,0.0,#Div0
south,0,0,1,0,1,0.0,#Div0,#Div0
valiable,0,0,0,1,1,#Div0,0.0,#Div0
pioneered,0,0,1,0,1,0.0,#Div0,#Div0
ussual,0,0,1,0,1,0.0,#Div0,#Div0
exiciting,0,0,1,0,1,0.0,#Div0,#Div0
send,0,1,0,1,2,#Div0,0.0,#Div0
desagreeing,0,0,1,0,1,0.0,#Div0,#Div0
seize,0,0,0,1,1,#Div0,0.0,#Div0
verify,0,0,1,0,1,0.0,#Div0,#Div0
gets,0,5,0,1,6,#Div0,0.0,#Div0
diffent,0,0,1,0,1,0.0,#Div0,#Div0
form,0,4,2,1,7,0.0,0.0,#Div0
argue,0,2,2,0,4,0.0,#Div0,#Div0
litte,0,0,0,1,1,#Div0,0.0,#Div0
memorize,0,4,3,0,7,0.0,#Div0,#Div0
confident,0,3,0,1,4,#Div0,0.0,#Div0
oving,1,0,0,0,1,1.0,1.0,1.0
remote,0,1,0,1,2,#Div0,0.0,#Div0
becasue,0,1,1,0,2,0.0,#Div0,#Div0
outsiders,0,0,0,1,1,#Div0,0.0,#Div0
space,0,4,0,5,9,#Div0,0.0,#Div0
security,0,5,0,1,6,#Div0,0.0,#Div0
totaly,0,0,1,0,1,0.0,#Div0,#Div0
restricted,0,0,0,1,1,#Div0,0.0,#Div0
wonderful,0,1,1,0,2,0.0,#Div0,#Div0
Seeing,2,0,0,0,2,1.0,1.0,1.0
expands,0,0,0,1,1,#Div0,0.0,#Div0
virtual,0,0,1,0,1,0.0,#Div0,#Div0
faces,0,0,0,3,3,#Div0,0.0,#Div0
challanges,0,0,0,1,1,#Div0,0.0,#Div0
limitaions,0,0,0,1,1,#Div0,0.0,#Div0
consequences,0,3,0,1,4,#Div0,0.0,#Div0
diet,0,0,1,0,1,0.0,#Div0,#Div0
increase,0,22,5,2,29,0.0,0.0,#Div0
reached,0,0,0,7,7,#Div0,0.0,#Div0
max,0,0,0,1,1,#Div0,0.0,#Div0
innovative,0,4,2,0,6,0.0,#Div0,#Div0
tecnical,0,0,1,0,1,0.0,#Div0,#Div0
introduced,0,1,0,1,2,#Div0,0.0,#Div0
happy,0,14,1,0,15,0.0,#Div0,#Div0
overpushed,0,0,0,1,1,#Div0,0.0,#Div0
pricy,0,1,1,0,2,0.0,#Div0,#Div0
range,0,8,0,1,9,#Div0,0.0,#Div0
accomplish,0,1,2,0,3,0.0,#Div0,#Div0
up,0,33,0,17,50,#Div0,0.0,#Div0
lie,0,4,1,0,5,0.0,#Div0,#Div0
m,0,10,10,0,20,0.0,#Div0,#Div0
overestimate,0,0,1,0,1,0.0,#Div0,#Div0
enough,0,23,34,0,57,0.0,#Div0,#Div0
educatinal,0,0,1,0,1,0.0,#Div0,#Div0
connections,0,0,0,1,1,#Div0,0.0,#Div0
nowadays,0,21,1,0,22,0.0,#Div0,#Div0
established,0,3,0,3,6,#Div0,0.0,#Div0
side,0,5,0,2,7,#Div0,0.0,#Div0
time-consuming,1,0,0,0,1,1.0,1.0,1.0
orginal,0,0,1,0,1,0.0,#Div0,#Div0
strictly,0,0,0,1,1,#Div0,0.0,#Div0
highlights,0,0,0,1,1,#Div0,0.0,#Div0
deliver,0,0,0,1,1,#Div0,0.0,#Div0
its,0,36,0,1,37,#Div0,0.0,#Div0
thorough,0,2,1,0,3,0.0,#Div0,#Div0
green,0,0,0,1,1,#Div0,0.0,#Div0
tell,0,4,5,0,9,0.0,#Div0,#Div0
sides,0,0,0,2,2,#Div0,0.0,#Div0
somewhere,0,4,1,1,6,0.0,0.0,#Div0
running,0,2,0,2,4,#Div0,0.0,#Div0
christmas,0,0,1,0,1,0.0,#Div0,#Div0
rapidly,0,3,0,1,4,#Div0,0.0,#Div0
restriction,0,0,0,1,1,#Div0,0.0,#Div0
related,0,12,1,0,13,0.0,#Div0,#Div0
affordable,0,0,1,0,1,0.0,#Div0,#Div0
damage,0,0,0,1,1,#Div0,0.0,#Div0
stimulate,0,0,1,0,1,0.0,#Div0,#Div0
Lonely,0,0,1,0,1,0.0,#Div0,#Div0
spread,2,1,0,2,5,1.0,0.5,0.6666666666666666
intruduced,0,0,0,1,1,#Div0,0.0,#Div0
leding,0,0,2,0,2,0.0,#Div0,#Div0
is,0,1023,0,1,1024,#Div0,0.0,#Div0
fist,0,0,2,0,2,0.0,#Div0,#Div0
suit,0,0,1,1,2,0.0,0.0,#Div0
tolerance,0,0,0,1,1,#Div0,0.0,#Div0
false,0,5,1,1,7,0.0,0.0,#Div0
visualize,0,0,0,2,2,#Div0,0.0,#Div0
proportioned,0,0,0,1,1,#Div0,0.0,#Div0
analizing,0,0,1,0,1,0.0,#Div0,#Div0
only,0,113,3,0,116,0.0,#Div0,#Div0
seek,1,0,0,1,2,1.0,0.5,0.6666666666666666
present,0,11,1,0,12,0.0,#Div0,#Div0
chalinging,0,0,0,1,1,#Div0,0.0,#Div0
gap,0,0,0,3,3,#Div0,0.0,#Div0
semester,0,0,0,2,2,#Div0,0.0,#Div0
responsible,0,4,2,0,6,0.0,#Div0,#Div0
using,0,34,0,1,35,#Div0,0.0,#Div0
focused,0,0,0,4,4,#Div0,0.0,#Div0
unreal,0,0,0,1,1,#Div0,0.0,#Div0
therefore,0,13,1,0,14,0.0,#Div0,#Div0
torue,0,0,1,0,1,0.0,#Div0,#Div0
advatages,0,0,0,1,1,#Div0,0.0,#Div0
handle,1,0,0,0,1,1.0,1.0,1.0
Sharing,0,0,1,0,1,0.0,#Div0,#Div0
thi,0,0,1,0,1,0.0,#Div0,#Div0
design,0,10,1,0,11,0.0,#Div0,#Div0
burst,0,0,0,1,1,#Div0,0.0,#Div0
hand,0,33,0,3,36,#Div0,0.0,#Div0
tend,0,1,13,0,14,0.0,#Div0,#Div0
destination,0,2,0,1,3,#Div0,0.0,#Div0
load,0,0,0,2,2,#Div0,0.0,#Div0
against,0,6,0,1,7,#Div0,0.0,#Div0
battles,0,0,0,1,1,#Div0,0.0,#Div0
extend,0,0,0,1,1,#Div0,0.0,#Div0
Immagine,0,1,1,0,2,0.0,#Div0,#Div0
filled,0,0,0,1,1,#Div0,0.0,#Div0
catch,1,0,0,0,1,1.0,1.0,1.0
geographic,0,0,1,0,1,0.0,#Div0,#Div0
actively,0,1,0,1,2,#Div0,0.0,#Div0
through,0,21,0,4,25,#Div0,0.0,#Div0
politician,0,0,1,0,1,0.0,#Div0,#Div0
theory,0,8,0,1,9,#Div0,0.0,#Div0
clever,0,0,1,0,1,0.0,#Div0,#Div0
moving,0,4,0,2,6,#Div0,0.0,#Div0
rent,0,1,1,0,2,0.0,#Div0,#Div0
conscience,0,0,0,2,2,#Div0,0.0,#Div0
see,4,32,23,1,60,0.14814814814814814,0.8,0.25
beginning,0,2,0,1,3,#Div0,0.0,#Div0
