token,tp_cases,tn_cases,fp_cases,fn_cases,total_cases,precision,recall,f1-score
by,0,259,0,3,262,#Div0,0.0,#Div0
population,0,17,0,1,18,#Div0,0.0,#Div0
balance,0,0,0,1,1,#Div0,0.0,#Div0
lose,0,3,0,8,11,#Div0,0.0,#Div0
incorrect,0,1,0,1,2,#Div0,0.0,#Div0
protect,0,1,0,3,4,#Div0,0.0,#Div0
reaching,0,0,0,5,5,#Div0,0.0,#Div0
suppoting,0,0,0,1,1,#Div0,0.0,#Div0
rare,0,0,0,1,1,#Div0,0.0,#Div0
obtain,0,4,0,5,9,#Div0,0.0,#Div0
angles,0,1,0,1,2,#Div0,0.0,#Div0
huge,0,11,0,1,12,#Div0,0.0,#Div0
picturelize,0,0,0,1,1,#Div0,0.0,#Div0
consume,0,1,0,2,3,#Div0,0.0,#Div0
gives,0,12,0,14,26,#Div0,0.0,#Div0
obstacles,0,0,0,1,1,#Div0,0.0,#Div0
disappear,0,3,0,1,4,#Div0,0.0,#Div0
refocus,0,0,0,1,1,#Div0,0.0,#Div0
view,0,7,0,6,13,#Div0,0.0,#Div0
dreaming,0,0,0,1,1,#Div0,0.0,#Div0
sons,0,0,0,1,1,#Div0,0.0,#Div0
forming,0,0,0,2,2,#Div0,0.0,#Div0
struck,0,0,0,1,1,#Div0,0.0,#Div0
conscience,0,0,0,2,2,#Div0,0.0,#Div0
short,0,13,0,1,14,#Div0,0.0,#Div0
leading,0,0,0,2,2,#Div0,0.0,#Div0
town,0,1,0,2,3,#Div0,0.0,#Div0
visibility,0,0,0,2,2,#Div0,0.0,#Div0
forbidden,0,0,0,1,1,#Div0,0.0,#Div0
warmth,0,0,0,1,1,#Div0,0.0,#Div0
gather,0,1,0,2,3,#Div0,0.0,#Div0
lower,0,4,0,1,5,#Div0,0.0,#Div0
position,0,6,0,3,9,#Div0,0.0,#Div0
move,0,13,1,1,15,0.0,0.0,#Div0
comforatable,0,0,0,1,1,#Div0,0.0,#Div0
sustaine,0,0,0,1,1,#Div0,0.0,#Div0
losing,0,0,0,4,4,#Div0,0.0,#Div0
sector,0,1,0,1,2,#Div0,0.0,#Div0
lead,0,4,0,14,18,#Div0,0.0,#Div0
focused,0,0,0,4,4,#Div0,0.0,#Div0
progres,0,0,0,1,1,#Div0,0.0,#Div0
passive,0,0,0,1,1,#Div0,0.0,#Div0
covers,0,0,0,1,1,#Div0,0.0,#Div0
grasping,0,0,0,1,1,#Div0,0.0,#Div0
led,0,28,0,1,29,#Div0,0.0,#Div0
grade,0,3,0,1,4,#Div0,0.0,#Div0
connecting,0,0,0,1,1,#Div0,0.0,#Div0
superficial,0,0,0,1,1,#Div0,0.0,#Div0
mislead,0,0,0,1,1,#Div0,0.0,#Div0
encourages,0,1,0,1,2,#Div0,0.0,#Div0
gifted,0,0,0,1,1,#Div0,0.0,#Div0
disaster,0,1,0,2,3,#Div0,0.0,#Div0
catastrophic,0,0,0,1,1,#Div0,0.0,#Div0
stricted,0,0,0,1,1,#Div0,0.0,#Div0
message,0,1,0,1,2,#Div0,0.0,#Div0
deely,0,0,0,1,1,#Div0,0.0,#Div0
nature,0,3,0,1,4,#Div0,0.0,#Div0
asset,0,0,0,1,1,#Div0,0.0,#Div0
into,0,11,0,11,22,#Div0,0.0,#Div0
interact,0,5,0,1,6,#Div0,0.0,#Div0
beyond,0,0,0,2,2,#Div0,0.0,#Div0
need,0,83,0,1,84,#Div0,0.0,#Div0
guide,0,123,0,2,125,#Div0,0.0,#Div0
fixing,0,0,0,1,1,#Div0,0.0,#Div0
directed,0,0,0,2,2,#Div0,0.0,#Div0
a,0,1358,0,6,1364,#Div0,0.0,#Div0
followed,0,2,0,1,3,#Div0,0.0,#Div0
start,0,22,0,3,25,#Div0,0.0,#Div0
tough,0,4,0,1,5,#Div0,0.0,#Div0
spikes,0,0,0,1,1,#Div0,0.0,#Div0
more,0,411,0,3,414,#Div0,0.0,#Div0
limit,0,2,0,4,6,#Div0,0.0,#Div0
tomorrow,0,0,0,2,2,#Div0,0.0,#Div0
stand,0,1,0,2,3,#Div0,0.0,#Div0
responds,0,0,0,1,1,#Div0,0.0,#Div0
enter,0,3,1,0,4,0.0,#Div0,#Div0
exotic,0,0,0,1,1,#Div0,0.0,#Div0
defend,0,0,0,1,1,#Div0,0.0,#Div0
dreams,0,1,0,1,2,#Div0,0.0,#Div0
miss,0,1,0,4,5,#Div0,0.0,#Div0
contribut,0,0,0,1,1,#Div0,0.0,#Div0
backgrounds,0,1,0,1,2,#Div0,0.0,#Div0
sorrounds,0,0,0,1,1,#Div0,0.0,#Div0
going,0,55,0,3,58,#Div0,0.0,#Div0
rich,0,5,0,3,8,#Div0,0.0,#Div0
saved,0,2,0,1,3,#Div0,0.0,#Div0
forward,0,0,0,2,2,#Div0,0.0,#Div0
fight,0,0,0,4,4,#Div0,0.0,#Div0
stage,0,3,0,9,12,#Div0,0.0,#Div0
at,0,130,0,1,131,#Div0,0.0,#Div0
brith,0,0,0,1,1,#Div0,0.0,#Div0
challange,0,0,0,1,1,#Div0,0.0,#Div0
elements,0,1,0,2,3,#Div0,0.0,#Div0
handling,0,0,0,2,2,#Div0,0.0,#Div0
preserving,0,0,0,1,1,#Div0,0.0,#Div0
overpushed,0,0,0,1,1,#Div0,0.0,#Div0
stability,0,0,0,2,2,#Div0,0.0,#Div0
various,0,6,5,0,11,0.0,#Div0,#Div0
following,0,9,0,1,10,#Div0,0.0,#Div0
very,0,128,0,1,129,#Div0,0.0,#Div0
relied,0,0,0,1,1,#Div0,0.0,#Div0
shattered,0,0,0,1,1,#Div0,0.0,#Div0
extend,0,0,0,1,1,#Div0,0.0,#Div0
dagerousness,0,0,0,1,1,#Div0,0.0,#Div0
steps,0,0,0,2,2,#Div0,0.0,#Div0
remote,0,1,0,1,2,#Div0,0.0,#Div0
craizy,0,0,0,1,1,#Div0,0.0,#Div0
spare,0,1,0,2,3,#Div0,0.0,#Div0
paving,0,0,0,1,1,#Div0,0.0,#Div0
vision,0,1,0,3,4,#Div0,0.0,#Div0
ladder,0,0,0,3,3,#Div0,0.0,#Div0
feed,0,1,0,1,2,#Div0,0.0,#Div0
judging,0,0,0,1,1,#Div0,0.0,#Div0
background,0,7,0,3,10,#Div0,0.0,#Div0
dangerous,0,3,0,4,7,#Div0,0.0,#Div0
positoin,0,0,0,1,1,#Div0,0.0,#Div0
middle,0,1,0,2,3,#Div0,0.0,#Div0
margin,0,0,0,1,1,#Div0,0.0,#Div0
follow,0,0,0,12,12,#Div0,0.0,#Div0
activate,0,0,0,1,1,#Div0,0.0,#Div0
life,0,243,0,1,244,#Div0,0.0,#Div0
goal,0,15,0,3,18,#Div0,0.0,#Div0
reach,0,1,0,15,16,#Div0,0.0,#Div0
embed,0,0,0,1,1,#Div0,0.0,#Div0
protected,0,0,0,2,2,#Div0,0.0,#Div0
conciliating,0,0,0,1,1,#Div0,0.0,#Div0
devoting,0,0,0,1,1,#Div0,0.0,#Div0
aproach,0,0,0,1,1,#Div0,0.0,#Div0
animals,0,3,0,1,4,#Div0,0.0,#Div0
intensity,0,0,0,1,1,#Div0,0.0,#Div0
habbits,0,0,0,1,1,#Div0,0.0,#Div0
bond,0,0,0,1,1,#Div0,0.0,#Div0
secure,0,0,0,1,1,#Div0,0.0,#Div0
task,0,1,0,1,2,#Div0,0.0,#Div0
side,0,5,0,2,7,#Div0,0.0,#Div0
focus,0,0,0,12,12,#Div0,0.0,#Div0
deal,0,2,0,1,3,#Div0,0.0,#Div0
forced,0,0,0,4,4,#Div0,0.0,#Div0
ruin,0,0,0,1,1,#Div0,0.0,#Div0
have,0,501,0,72,573,#Div0,0.0,#Div0
refines,0,0,0,1,1,#Div0,0.0,#Div0
challenging,0,8,0,1,9,#Div0,0.0,#Div0
second,0,13,0,1,14,#Div0,0.0,#Div0
pay,0,8,0,5,13,#Div0,0.0,#Div0
selling,0,3,0,1,4,#Div0,0.0,#Div0
powerful,0,0,0,1,1,#Div0,0.0,#Div0
running,0,2,0,2,4,#Div0,0.0,#Div0
shier,0,0,0,1,1,#Div0,0.0,#Div0
moving,0,4,0,2,6,#Div0,0.0,#Div0
invest,0,2,0,1,3,#Div0,0.0,#Div0
knowled,0,0,0,1,1,#Div0,0.0,#Div0
spenting,0,0,0,1,1,#Div0,0.0,#Div0
connected,0,2,0,2,4,#Div0,0.0,#Div0
tasteless,0,0,0,1,1,#Div0,0.0,#Div0
point,0,26,0,4,30,#Div0,0.0,#Div0
autum,0,0,0,1,1,#Div0,0.0,#Div0
worth,0,1,0,1,2,#Div0,0.0,#Div0
tools,0,0,0,5,5,#Div0,0.0,#Div0
beginning,0,2,0,1,3,#Div0,0.0,#Div0
strict,0,0,0,1,1,#Div0,0.0,#Div0
solid,0,0,0,1,1,#Div0,0.0,#Div0
builds,0,0,0,2,2,#Div0,0.0,#Div0
flexible,0,0,0,3,3,#Div0,0.0,#Div0
challanges,0,0,0,1,1,#Div0,0.0,#Div0
given,0,7,0,2,9,#Div0,0.0,#Div0
correction,0,0,0,1,1,#Div0,0.0,#Div0
comfetable,0,1,0,1,2,#Div0,0.0,#Div0
strongly,0,2,0,13,15,#Div0,0.0,#Div0
increases,0,1,0,1,2,#Div0,0.0,#Div0
price,0,13,0,1,14,#Div0,0.0,#Div0
entering,0,0,0,2,2,#Div0,0.0,#Div0
legacy,0,0,0,1,1,#Div0,0.0,#Div0
perception,0,0,0,1,1,#Div0,0.0,#Div0
messages,0,0,0,1,1,#Div0,0.0,#Div0
late,0,5,0,2,7,#Div0,0.0,#Div0
messege,0,0,0,1,1,#Div0,0.0,#Div0
disabled,0,0,1,0,1,0.0,#Div0,#Div0
experiments,0,0,0,1,1,#Div0,0.0,#Div0
evolution,0,0,0,1,1,#Div0,0.0,#Div0
direvered,0,0,0,1,1,#Div0,0.0,#Div0
eliminates,0,0,0,1,1,#Div0,0.0,#Div0
receive,0,3,0,1,4,#Div0,0.0,#Div0
share,0,6,0,2,8,#Div0,0.0,#Div0
crash,0,0,0,1,1,#Div0,0.0,#Div0
proportion,0,0,0,1,1,#Div0,0.0,#Div0
structure,0,1,0,2,3,#Div0,0.0,#Div0
example,0,137,0,1,138,#Div0,0.0,#Div0
talking,0,8,0,2,10,#Div0,0.0,#Div0
relax,0,1,0,1,2,#Div0,0.0,#Div0
space,0,4,0,5,9,#Div0,0.0,#Div0
cheap,0,7,0,1,8,#Div0,0.0,#Div0
written,0,5,0,1,6,#Div0,0.0,#Div0
aspects,0,12,0,2,14,#Div0,0.0,#Div0
waste,0,0,0,6,6,#Div0,0.0,#Div0
reduces,0,0,0,1,1,#Div0,0.0,#Div0
gap,0,0,0,3,3,#Div0,0.0,#Div0
advancement,0,0,0,4,4,#Div0,0.0,#Div0
moved,0,4,0,2,6,#Div0,0.0,#Div0
held,0,0,0,1,1,#Div0,0.0,#Div0
strengthen,0,0,0,1,1,#Div0,0.0,#Div0
requires,0,10,0,3,13,#Div0,0.0,#Div0
straight,0,0,0,1,1,#Div0,0.0,#Div0
develope,0,4,0,1,5,#Div0,0.0,#Div0
competing,0,0,0,2,2,#Div0,0.0,#Div0
besic,0,0,0,1,1,#Div0,0.0,#Div0
early,0,6,0,1,7,#Div0,0.0,#Div0
filling,0,0,0,1,1,#Div0,0.0,#Div0
under,0,2,0,1,3,#Div0,0.0,#Div0
kept,0,1,0,1,2,#Div0,0.0,#Div0
narrow,0,0,0,3,3,#Div0,0.0,#Div0
reduce,0,0,0,1,1,#Div0,0.0,#Div0
Greenhouse,0,0,0,1,1,#Div0,0.0,#Div0
gaining,0,1,0,1,2,#Div0,0.0,#Div0
later,0,6,0,1,7,#Div0,0.0,#Div0
make,0,155,0,3,158,#Div0,0.0,#Div0
optimize,0,0,0,1,1,#Div0,0.0,#Div0
areas,0,6,0,1,7,#Div0,0.0,#Div0
grows,0,0,0,1,1,#Div0,0.0,#Div0
original,0,2,0,1,3,#Div0,0.0,#Div0
complement,0,0,0,1,1,#Div0,0.0,#Div0
stores,0,2,0,1,3,#Div0,0.0,#Div0
confines,0,0,0,1,1,#Div0,0.0,#Div0
widening,0,0,0,1,1,#Div0,0.0,#Div0
energy,0,23,0,1,24,#Div0,0.0,#Div0
underlining,0,0,0,1,1,#Div0,0.0,#Div0
diffused,0,0,0,1,1,#Div0,0.0,#Div0
teach,0,11,0,2,13,#Div0,0.0,#Div0
challenge,0,2,0,1,3,#Div0,0.0,#Div0
works,0,16,0,1,17,#Div0,0.0,#Div0
sit,0,0,0,1,1,#Div0,0.0,#Div0
fill,1,0,0,1,2,1.0,0.5,0.6666666666666666
concentration,0,0,0,1,1,#Div0,0.0,#Div0
developing,0,8,0,1,9,#Div0,0.0,#Div0
illustrated,0,1,0,1,2,#Div0,0.0,#Div0
tase,0,0,0,1,1,#Div0,0.0,#Div0
carrier,0,0,0,1,1,#Div0,0.0,#Div0
dedicate,0,1,0,7,8,#Div0,0.0,#Div0
destroying,0,1,0,1,2,#Div0,0.0,#Div0
priceless,0,0,0,1,1,#Div0,0.0,#Div0
go,0,65,6,10,81,0.0,0.0,#Div0
gain,0,4,0,3,7,#Div0,0.0,#Div0
Strongly,0,0,0,1,1,#Div0,0.0,#Div0
based,0,5,0,10,15,#Div0,0.0,#Div0
wastful,0,0,0,1,1,#Div0,0.0,#Div0
supports,0,2,0,2,4,#Div0,0.0,#Div0
devastating,0,0,0,1,1,#Div0,0.0,#Div0
discoverd,0,0,0,1,1,#Div0,0.0,#Div0
defended,0,0,0,1,1,#Div0,0.0,#Div0
most,0,95,0,1,96,#Div0,0.0,#Div0
evolved,0,0,0,1,1,#Div0,0.0,#Div0
village,0,0,0,1,1,#Div0,0.0,#Div0
max,0,0,0,1,1,#Div0,0.0,#Div0
concentrated,0,0,0,1,1,#Div0,0.0,#Div0
pick,0,0,0,2,2,#Div0,0.0,#Div0
overwhelm,0,0,0,1,1,#Div0,0.0,#Div0
impact,0,0,0,1,1,#Div0,0.0,#Div0
level,0,5,0,7,12,#Div0,0.0,#Div0
false,0,6,0,1,7,#Div0,0.0,#Div0
closed,0,0,0,1,1,#Div0,0.0,#Div0
allocating,0,0,0,1,1,#Div0,0.0,#Div0
bonds,0,0,0,1,1,#Div0,0.0,#Div0
available,0,12,0,4,16,#Div0,0.0,#Div0
rapidly,0,3,0,1,4,#Div0,0.0,#Div0
develop,0,7,0,5,12,#Div0,0.0,#Div0
speak,0,11,1,0,12,0.0,#Div0,#Div0
step,0,1,0,3,4,#Div0,0.0,#Div0
bravery,0,0,0,1,1,#Div0,0.0,#Div0
meaninngless,0,0,0,1,1,#Div0,0.0,#Div0
went,0,14,0,1,15,#Div0,0.0,#Div0
serious,0,4,0,1,5,#Div0,0.0,#Div0
our,0,107,0,1,108,#Div0,0.0,#Div0
entered,0,1,0,1,2,#Div0,0.0,#Div0
spring,0,0,0,1,1,#Div0,0.0,#Div0
grow,0,5,0,10,15,#Div0,0.0,#Div0
edge,0,0,0,1,1,#Div0,0.0,#Div0
touched,0,0,0,2,2,#Div0,0.0,#Div0
studied,0,17,1,0,18,0.0,#Div0,#Div0
risk,0,19,0,1,20,#Div0,0.0,#Div0
harm,0,1,0,1,2,#Div0,0.0,#Div0
feel,0,41,0,3,44,#Div0,0.0,#Div0
taught,0,7,0,1,8,#Div0,0.0,#Div0
enlarge,0,0,0,2,2,#Div0,0.0,#Div0
circle,0,0,0,1,1,#Div0,0.0,#Div0
killers,0,0,0,1,1,#Div0,0.0,#Div0
keeping,0,2,0,1,3,#Div0,0.0,#Div0
appeal,0,0,0,1,1,#Div0,0.0,#Div0
common,0,8,0,1,9,#Div0,0.0,#Div0
unreal,0,0,0,1,1,#Div0,0.0,#Div0
broke,0,1,0,1,2,#Div0,0.0,#Div0
focuses,0,0,0,3,3,#Div0,0.0,#Div0
put,0,2,0,7,9,#Div0,0.0,#Div0
symbol,0,0,0,2,2,#Div0,0.0,#Div0
approaching,0,0,0,1,1,#Div0,0.0,#Div0
opened,0,0,0,1,1,#Div0,0.0,#Div0
lies,0,1,0,1,2,#Div0,0.0,#Div0
load,0,0,0,2,2,#Div0,0.0,#Div0
nightmare,0,0,0,1,1,#Div0,0.0,#Div0
intoduced,0,0,0,1,1,#Div0,0.0,#Div0
dispose,0,0,0,1,1,#Div0,0.0,#Div0
obliges,0,0,0,1,1,#Div0,0.0,#Div0
leads,0,1,0,10,11,#Div0,0.0,#Div0
fundamental,0,1,0,1,2,#Div0,0.0,#Div0
sends,0,0,0,1,1,#Div0,0.0,#Div0
survive,0,2,0,2,4,#Div0,0.0,#Div0
connect,0,0,0,3,3,#Div0,0.0,#Div0
fruitfull,0,0,0,1,1,#Div0,0.0,#Div0
fake,0,0,0,1,1,#Div0,0.0,#Div0
spend,0,13,0,37,50,#Div0,0.0,#Div0
and,0,1557,0,1,1558,#Div0,0.0,#Div0
keys,0,0,0,1,1,#Div0,0.0,#Div0
loose,0,1,0,2,3,#Div0,0.0,#Div0
accquire,0,0,0,1,1,#Div0,0.0,#Div0
actor,0,0,0,1,1,#Div0,0.0,#Div0
reject,0,0,0,1,1,#Div0,0.0,#Div0
sacrificing,0,0,0,1,1,#Div0,0.0,#Div0
sacrifice,0,0,0,1,1,#Div0,0.0,#Div0
drive,0,5,0,1,6,#Div0,0.0,#Div0
earned,0,0,0,2,2,#Div0,0.0,#Div0
underlined,0,0,0,1,1,#Div0,0.0,#Div0
arm,0,0,0,1,1,#Div0,0.0,#Div0
reachable,0,0,0,1,1,#Div0,0.0,#Div0
throw,0,0,0,1,1,#Div0,0.0,#Div0
green-house,0,0,0,1,1,#Div0,0.0,#Div0
fully,0,2,0,6,8,#Div0,0.0,#Div0
long,0,26,0,1,27,#Div0,0.0,#Div0
study,0,48,5,0,53,0.0,#Div0,#Div0
give,0,28,0,35,63,#Div0,0.0,#Div0
enemys,0,0,0,1,1,#Div0,0.0,#Div0
flying,0,0,0,1,1,#Div0,0.0,#Div0
Reaching,0,0,0,1,1,#Div0,0.0,#Div0
addicted,0,0,0,1,1,#Div0,0.0,#Div0
direction,0,1,0,2,3,#Div0,0.0,#Div0
to,0,2038,0,3,2041,#Div0,0.0,#Div0
rigid,0,0,0,1,1,#Div0,0.0,#Div0
wrning,0,0,0,1,1,#Div0,0.0,#Div0
chalinging,0,0,0,1,1,#Div0,0.0,#Div0
shallow,0,0,0,1,1,#Div0,0.0,#Div0
complexities,0,0,0,1,1,#Div0,0.0,#Div0
in,0,1100,0,18,1118,#Div0,0.0,#Div0
bring,0,4,0,4,8,#Div0,0.0,#Div0
sharp,0,0,0,1,1,#Div0,0.0,#Div0
connector,0,0,0,1,1,#Div0,0.0,#Div0
stupid,0,0,0,1,1,#Div0,0.0,#Div0
trials,0,0,0,1,1,#Div0,0.0,#Div0
tolerance,0,0,0,1,1,#Div0,0.0,#Div0
somewhere,0,5,0,1,6,#Div0,0.0,#Div0
system,0,8,0,2,10,#Div0,0.0,#Div0
year,0,19,0,1,20,#Div0,0.0,#Div0
exploring,0,0,0,2,2,#Div0,0.0,#Div0
steady,0,0,0,4,4,#Div0,0.0,#Div0
surface,0,1,0,1,2,#Div0,0.0,#Div0
sight,0,2,0,1,3,#Div0,0.0,#Div0
cutting-edge,0,0,0,1,1,#Div0,0.0,#Div0
attached,0,0,0,1,1,#Div0,0.0,#Div0
shows,0,11,0,2,13,#Div0,0.0,#Div0
avalible,0,0,0,1,1,#Div0,0.0,#Div0
depicted,0,0,0,1,1,#Div0,0.0,#Div0
vibrant,0,0,0,1,1,#Div0,0.0,#Div0
activeusefull,0,0,0,1,1,#Div0,0.0,#Div0
calculate,0,1,0,1,2,#Div0,0.0,#Div0
reap,0,0,0,1,1,#Div0,0.0,#Div0
time-consuming,0,0,0,1,1,#Div0,0.0,#Div0
scheme,0,0,0,1,1,#Div0,0.0,#Div0
filled,0,0,0,1,1,#Div0,0.0,#Div0
adjust,0,1,0,1,2,#Div0,0.0,#Div0
points,0,3,0,1,4,#Div0,0.0,#Div0
bound,0,0,0,2,2,#Div0,0.0,#Div0
other,0,177,0,1,178,#Div0,0.0,#Div0
proportioned,0,0,0,1,1,#Div0,0.0,#Div0
deep,0,0,0,6,6,#Div0,0.0,#Div0
eyes,0,0,0,1,1,#Div0,0.0,#Div0
multiply,0,1,0,1,2,#Div0,0.0,#Div0
made,0,32,0,1,33,#Div0,0.0,#Div0
travel,0,71,13,0,84,0.0,#Div0,#Div0
win,0,0,0,1,1,#Div0,0.0,#Div0
private,0,9,0,1,10,#Div0,0.0,#Div0
era,0,0,0,5,5,#Div0,0.0,#Div0
Taking,0,1,0,1,2,#Div0,0.0,#Div0
platform,0,0,0,1,1,#Div0,0.0,#Div0
undermine,0,1,0,1,2,#Div0,0.0,#Div0
supporting,0,0,0,1,1,#Div0,0.0,#Div0
fixed,0,0,0,1,1,#Div0,0.0,#Div0
climb,0,1,0,1,2,#Div0,0.0,#Div0
line,0,1,0,3,4,#Div0,0.0,#Div0
fitting,0,0,0,1,1,#Div0,0.0,#Div0
colder,0,0,0,1,1,#Div0,0.0,#Div0
case,0,27,0,1,28,#Div0,0.0,#Div0
isolated,0,0,0,1,1,#Div0,0.0,#Div0
pressures,0,0,0,2,2,#Div0,0.0,#Div0
supplyment,0,0,0,1,1,#Div0,0.0,#Div0
restrict,0,1,0,1,2,#Div0,0.0,#Div0
complete,0,4,0,2,6,#Div0,0.0,#Div0
attachment,0,0,0,2,2,#Div0,0.0,#Div0
limited,0,4,0,5,9,#Div0,0.0,#Div0
away,0,7,0,5,12,#Div0,0.0,#Div0
encounter,0,0,0,1,1,#Div0,0.0,#Div0
law,0,13,0,1,14,#Div0,0.0,#Div0
pull,0,0,0,1,1,#Div0,0.0,#Div0
giving,0,6,0,4,10,#Div0,0.0,#Div0
trap,0,0,0,1,1,#Div0,0.0,#Div0
thru,0,0,0,1,1,#Div0,0.0,#Div0
linked,0,0,0,1,1,#Div0,0.0,#Div0
mamage,0,0,0,1,1,#Div0,0.0,#Div0
safe,0,2,0,2,4,#Div0,0.0,#Div0
traditional,0,2,0,1,3,#Div0,0.0,#Div0
burst,0,0,0,1,1,#Div0,0.0,#Div0
outside,0,3,0,2,5,#Div0,0.0,#Div0
unlimited,0,0,0,1,1,#Div0,0.0,#Div0
kings,0,0,0,1,1,#Div0,0.0,#Div0
starting,0,2,0,1,3,#Div0,0.0,#Div0
atmosphere,0,2,0,1,3,#Div0,0.0,#Div0
shiny,0,1,0,1,2,#Div0,0.0,#Div0
appealing,0,0,0,2,2,#Div0,0.0,#Div0
peak,0,0,0,1,1,#Div0,0.0,#Div0
basis,0,1,0,3,4,#Div0,0.0,#Div0
offer,0,1,0,3,4,#Div0,0.0,#Div0
array,0,0,0,2,2,#Div0,0.0,#Div0
rules,0,2,0,1,3,#Div0,0.0,#Div0
cutting,0,0,0,1,1,#Div0,0.0,#Div0
valiable,0,0,0,1,1,#Div0,0.0,#Div0
spending,0,2,0,5,7,#Div0,0.0,#Div0
advantages,0,13,0,1,14,#Div0,0.0,#Div0
same,0,64,0,1,65,#Div0,0.0,#Div0
accelerating,0,0,0,1,1,#Div0,0.0,#Div0
graps,0,0,0,1,1,#Div0,0.0,#Div0
manage,0,0,0,2,2,#Div0,0.0,#Div0
healthy,0,9,0,1,10,#Div0,0.0,#Div0
inside,0,2,0,2,4,#Div0,0.0,#Div0
neutral,0,0,0,1,1,#Div0,0.0,#Div0
having,0,45,0,5,50,#Div0,0.0,#Div0
grant,0,1,0,2,3,#Div0,0.0,#Div0
help,0,131,0,2,133,#Div0,0.0,#Div0
get,0,77,0,13,90,#Div0,0.0,#Div0
handy,0,0,0,2,2,#Div0,0.0,#Div0
devices,0,1,0,1,2,#Div0,0.0,#Div0
strong,0,1,0,18,19,#Div0,0.0,#Div0
handle,0,0,0,1,1,#Div0,0.0,#Div0
focalized,0,0,0,1,1,#Div0,0.0,#Div0
pursued,0,0,0,1,1,#Div0,0.0,#Div0
spirit,0,0,0,1,1,#Div0,0.0,#Div0
few,0,27,1,0,28,0.0,#Div0,#Div0
piece,0,0,0,1,1,#Div0,0.0,#Div0
extract,0,0,0,1,1,#Div0,0.0,#Div0
slower,0,0,0,1,1,#Div0,0.0,#Div0
horrifying,0,0,0,1,1,#Div0,0.0,#Div0
last,0,10,0,2,12,#Div0,0.0,#Div0
sound,0,3,0,2,5,#Div0,0.0,#Div0
hiding,0,0,0,1,1,#Div0,0.0,#Div0
cram,0,0,1,0,1,0.0,#Div0,#Div0
sides,0,0,0,2,2,#Div0,0.0,#Div0
means,0,29,0,1,30,#Div0,0.0,#Div0
restricted,0,0,0,1,1,#Div0,0.0,#Div0
multiplying,0,0,0,1,1,#Div0,0.0,#Div0
grew,0,1,0,2,3,#Div0,0.0,#Div0
isolte,0,0,0,1,1,#Div0,0.0,#Div0
wide,0,1,0,10,11,#Div0,0.0,#Div0
underline,0,0,0,1,1,#Div0,0.0,#Div0
two,0,32,0,1,33,#Div0,0.0,#Div0
found,0,19,0,1,20,#Div0,0.0,#Div0
greater,0,5,0,1,6,#Div0,0.0,#Div0
between,0,17,0,2,19,#Div0,0.0,#Div0
bit,0,2,0,1,3,#Div0,0.0,#Div0
shrink,0,0,0,1,1,#Div0,0.0,#Div0
relay,0,0,0,2,2,#Div0,0.0,#Div0
derives,0,0,0,1,1,#Div0,0.0,#Div0
support,0,6,0,20,26,#Div0,0.0,#Div0
play,0,3,2,1,6,0.0,0.0,#Div0
accidently,0,0,0,1,1,#Div0,0.0,#Div0
substained,0,0,0,1,1,#Div0,0.0,#Div0
with,0,428,0,2,430,#Div0,0.0,#Div0
keep,0,18,0,9,27,#Div0,0.0,#Div0
chase,0,0,0,1,1,#Div0,0.0,#Div0
loses,0,0,0,1,1,#Div0,0.0,#Div0
worthless,0,0,0,2,2,#Div0,0.0,#Div0
back,0,7,0,3,10,#Div0,0.0,#Div0
marginal,0,0,0,1,1,#Div0,0.0,#Div0
potentials,0,0,0,1,1,#Div0,0.0,#Div0
passions,0,0,0,1,1,#Div0,0.0,#Div0
reached,0,0,0,7,7,#Div0,0.0,#Div0
bright,0,1,0,1,2,#Div0,0.0,#Div0
of,0,1325,0,9,1334,#Div0,0.0,#Div0
tells,0,5,0,1,6,#Div0,0.0,#Div0
reveals,0,0,0,2,2,#Div0,0.0,#Div0
balanced,0,0,0,1,1,#Div0,0.0,#Div0
devotng,0,0,0,1,1,#Div0,0.0,#Div0
Spikes,0,0,0,1,1,#Div0,0.0,#Div0
find,0,47,0,7,54,#Div0,0.0,#Div0
attractions,0,0,0,1,1,#Div0,0.0,#Div0
advance,0,2,0,1,3,#Div0,0.0,#Div0
expands,0,0,0,1,1,#Div0,0.0,#Div0
run,1,1,0,6,8,1.0,0.14285714285714285,0.25
concentrate,0,1,0,1,2,#Div0,0.0,#Div0
overcome,0,0,0,3,3,#Div0,0.0,#Div0
dagerous,0,0,0,1,1,#Div0,0.0,#Div0
jams,0,0,0,1,1,#Div0,0.0,#Div0
fields,0,8,0,3,11,#Div0,0.0,#Div0
connections,0,0,0,1,1,#Div0,0.0,#Div0
color,0,4,0,1,5,#Div0,0.0,#Div0
blocked,0,0,0,1,1,#Div0,0.0,#Div0
shift,0,0,0,1,1,#Div0,0.0,#Div0
provide,0,10,0,3,13,#Div0,0.0,#Div0
Getting,0,0,0,1,1,#Div0,0.0,#Div0
hurm,0,0,0,1,1,#Div0,0.0,#Div0
close,0,3,0,4,7,#Div0,0.0,#Div0
wheel,0,0,0,2,2,#Div0,0.0,#Div0
basic,0,4,0,5,9,#Div0,0.0,#Div0
ways,0,24,0,2,26,#Div0,0.0,#Div0
kill,0,0,0,1,1,#Div0,0.0,#Div0
natural,0,3,0,2,5,#Div0,0.0,#Div0
near,0,1,0,1,2,#Div0,0.0,#Div0
exposed,0,0,0,1,1,#Div0,0.0,#Div0
explore,1,2,0,2,5,1.0,0.3333333333333333,0.5
increasing,0,17,0,1,18,#Div0,0.0,#Div0
serve,0,0,0,1,1,#Div0,0.0,#Div0
horizental,0,0,0,3,3,#Div0,0.0,#Div0
unstable,0,0,0,1,1,#Div0,0.0,#Div0
high,0,22,0,2,24,#Div0,0.0,#Div0
worlds,0,0,0,1,1,#Div0,0.0,#Div0
willing,0,9,0,1,10,#Div0,0.0,#Div0
engine,0,0,0,2,2,#Div0,0.0,#Div0
vast,0,1,0,2,3,#Div0,0.0,#Div0
collected,0,0,0,1,1,#Div0,0.0,#Div0
rewarding,0,2,0,2,4,#Div0,0.0,#Div0
indepth,0,0,0,1,1,#Div0,0.0,#Div0
inflate,0,0,0,1,1,#Div0,0.0,#Div0
visualize,0,0,0,2,2,#Div0,0.0,#Div0
comes,0,10,0,2,12,#Div0,0.0,#Div0
aintaining,0,0,0,1,1,#Div0,0.0,#Div0
dominated,0,0,0,1,1,#Div0,0.0,#Div0
spreading,0,0,0,1,1,#Div0,0.0,#Div0
cheating,0,1,0,3,4,#Div0,0.0,#Div0
spots,0,1,0,1,2,#Div0,0.0,#Div0
acquired,0,3,0,1,4,#Div0,0.0,#Div0
target,0,0,0,1,1,#Div0,0.0,#Div0
shoulders,0,0,0,2,2,#Div0,0.0,#Div0
tones,0,0,0,1,1,#Div0,0.0,#Div0
introduced,0,1,0,1,2,#Div0,0.0,#Div0
wider,0,0,0,4,4,#Div0,0.0,#Div0
far,0,7,0,5,12,#Div0,0.0,#Div0
power,0,0,0,2,2,#Div0,0.0,#Div0
strictly,0,0,0,1,1,#Div0,0.0,#Div0
door,0,0,0,1,1,#Div0,0.0,#Div0
dots,0,0,0,1,1,#Div0,0.0,#Div0
stars,0,0,0,1,1,#Div0,0.0,#Div0
advanced,0,5,0,2,7,#Div0,0.0,#Div0
area,0,5,0,1,6,#Div0,0.0,#Div0
little,0,26,0,2,28,#Div0,0.0,#Div0
limitations,0,0,0,1,1,#Div0,0.0,#Div0
part,0,27,0,12,39,#Div0,0.0,#Div0
stick,0,0,0,2,2,#Div0,0.0,#Div0
value,0,2,0,2,4,#Div0,0.0,#Div0
restrictions,0,0,0,2,2,#Div0,0.0,#Div0
chain,0,0,0,2,2,#Div0,0.0,#Div0
mess,0,0,0,1,1,#Div0,0.0,#Div0
forces,0,2,0,1,3,#Div0,0.0,#Div0
taking,0,24,0,6,30,#Div0,0.0,#Div0
suport,0,0,0,1,1,#Div0,0.0,#Div0
hectic,0,0,0,1,1,#Div0,0.0,#Div0
downsides,0,0,0,1,1,#Div0,0.0,#Div0
crowd,0,0,0,1,1,#Div0,0.0,#Div0
own,0,56,0,1,57,#Div0,0.0,#Div0
from,0,166,0,12,178,#Div0,0.0,#Div0
basesd,0,0,0,1,1,#Div0,0.0,#Div0
endure,0,0,0,1,1,#Div0,0.0,#Div0
forget,0,4,0,1,5,#Div0,0.0,#Div0
goes,0,7,0,1,8,#Div0,0.0,#Div0
approach,0,1,0,8,9,#Div0,0.0,#Div0
ruch,0,0,0,1,1,#Div0,0.0,#Div0
promoting,0,2,0,1,3,#Div0,0.0,#Div0
familiar,0,2,0,1,3,#Div0,0.0,#Div0
developed,0,9,0,2,11,#Div0,0.0,#Div0
pop,0,0,0,1,1,#Div0,0.0,#Div0
instruments,0,1,0,1,2,#Div0,0.0,#Div0
defined,0,0,0,1,1,#Div0,0.0,#Div0
faced,0,0,0,1,1,#Div0,0.0,#Div0
collage,0,0,0,1,1,#Div0,0.0,#Div0
providing,0,0,0,1,1,#Div0,0.0,#Div0
consequences,0,3,0,1,4,#Div0,0.0,#Div0
image,0,2,0,6,8,#Div0,0.0,#Div0
too,0,47,0,3,50,#Div0,0.0,#Div0
conduct,0,0,0,1,1,#Div0,0.0,#Div0
had,0,63,0,2,65,#Div0,0.0,#Div0
active,0,0,0,5,5,#Div0,0.0,#Div0
rely,0,0,0,3,3,#Div0,0.0,#Div0
security,0,5,0,1,6,#Div0,0.0,#Div0
respect,0,7,0,2,9,#Div0,0.0,#Div0
pushed,0,0,0,1,1,#Div0,0.0,#Div0
raised,0,1,0,1,2,#Div0,0.0,#Div0
quickly,0,6,0,1,7,#Div0,0.0,#Div0
off,0,3,0,1,4,#Div0,0.0,#Div0
hard,0,48,0,1,49,#Div0,0.0,#Div0
become,0,39,0,2,41,#Div0,0.0,#Div0
difficult,0,30,0,1,31,#Div0,0.0,#Div0
phase,0,0,0,2,2,#Div0,0.0,#Div0
competition,0,0,0,1,1,#Div0,0.0,#Div0
came,0,7,0,1,8,#Div0,0.0,#Div0
hold,0,0,0,2,2,#Div0,0.0,#Div0
hunger,0,0,0,1,1,#Div0,0.0,#Div0
warmly,0,0,0,1,1,#Div0,0.0,#Div0
hundred,0,0,0,1,1,#Div0,0.0,#Div0
parallel,0,0,0,1,1,#Div0,0.0,#Div0
pictures,0,1,0,1,2,#Div0,0.0,#Div0
zoo,0,0,0,1,1,#Div0,0.0,#Div0
around,0,32,0,3,35,#Div0,0.0,#Div0
static,0,0,0,1,1,#Div0,0.0,#Div0
pushs,0,0,0,1,1,#Div0,0.0,#Div0
jungle,0,0,0,1,1,#Div0,0.0,#Div0
growing,0,3,0,7,10,#Div0,0.0,#Div0
confortable,0,0,0,1,1,#Div0,0.0,#Div0
highlights,0,0,0,1,1,#Div0,0.0,#Div0
suffuring,0,0,0,1,1,#Div0,0.0,#Div0
oving,0,0,0,1,1,#Div0,0.0,#Div0
expanded,0,0,0,2,2,#Div0,0.0,#Div0
atomosphere,0,0,0,1,1,#Div0,0.0,#Div0
pace,0,0,0,1,1,#Div0,0.0,#Div0
taste,0,0,0,3,3,#Div0,0.0,#Div0
attact,0,0,0,1,1,#Div0,0.0,#Div0
felt,0,6,0,1,7,#Div0,0.0,#Div0
relationship,0,2,0,1,3,#Div0,0.0,#Div0
deeply,0,0,0,8,8,#Div0,0.0,#Div0
accessble,0,0,0,1,1,#Div0,0.0,#Div0
rise,0,1,0,1,2,#Div0,0.0,#Div0
dream,0,0,0,5,5,#Div0,0.0,#Div0
avoided,0,2,0,1,3,#Div0,0.0,#Div0
horizontal,0,0,0,1,1,#Div0,0.0,#Div0
fruitful,0,0,0,1,1,#Div0,0.0,#Div0
base,0,0,0,4,4,#Div0,0.0,#Div0
compel,0,0,0,1,1,#Div0,0.0,#Div0
increase,0,27,0,2,29,#Div0,0.0,#Div0
persuing,0,0,0,1,1,#Div0,0.0,#Div0
eloquent,0,0,0,1,1,#Div0,0.0,#Div0
loosing,0,0,0,1,1,#Div0,0.0,#Div0
contributing,0,0,0,1,1,#Div0,0.0,#Div0
asking,0,3,0,1,4,#Div0,0.0,#Div0
extra,0,2,0,2,4,#Div0,0.0,#Div0
consetrating,0,0,0,1,1,#Div0,0.0,#Div0
sorses,0,0,0,1,1,#Div0,0.0,#Div0
valued,0,0,0,1,1,#Div0,0.0,#Div0
obtained,0,0,0,1,1,#Div0,0.0,#Div0
legend,0,0,0,1,1,#Div0,0.0,#Div0
built,0,2,0,3,5,#Div0,0.0,#Div0
improvment,0,0,0,1,1,#Div0,0.0,#Div0
hand,0,33,0,3,36,#Div0,0.0,#Div0
valuable,0,2,0,2,4,#Div0,0.0,#Div0
percent,0,1,0,1,2,#Div0,0.0,#Div0
green,0,0,0,1,1,#Div0,0.0,#Div0
pampered,0,0,0,1,1,#Div0,0.0,#Div0
journey,0,6,0,2,8,#Div0,0.0,#Div0
world,0,70,0,8,78,#Div0,0.0,#Div0
stay,0,10,0,1,11,#Div0,0.0,#Div0
brought,0,0,0,2,2,#Div0,0.0,#Div0
conception,0,0,0,1,1,#Div0,0.0,#Div0
has,0,139,0,5,144,#Div0,0.0,#Div0
using,0,34,0,1,35,#Div0,0.0,#Div0
easy,0,21,0,1,22,#Div0,0.0,#Div0
passed,0,0,0,1,1,#Div0,0.0,#Div0
compete,0,1,0,1,2,#Div0,0.0,#Div0
great,0,24,0,1,25,#Div0,0.0,#Div0
surronded,0,0,0,1,1,#Div0,0.0,#Div0
takes,0,5,0,6,11,#Div0,0.0,#Div0
tolerating,0,0,0,1,1,#Div0,0.0,#Div0
abandon,0,0,0,2,2,#Div0,0.0,#Div0
belong,0,0,0,2,2,#Div0,0.0,#Div0
putting,0,0,0,2,2,#Div0,0.0,#Div0
reward,0,0,0,1,1,#Div0,0.0,#Div0
growth,0,6,0,4,10,#Div0,0.0,#Div0
deriving,0,0,0,2,2,#Div0,0.0,#Div0
mainstream,0,0,0,1,1,#Div0,0.0,#Div0
cheet,0,0,0,1,1,#Div0,0.0,#Div0
fought,0,0,0,1,1,#Div0,0.0,#Div0
spread,0,1,0,4,5,#Div0,0.0,#Div0
spends,0,1,0,2,3,#Div0,0.0,#Div0
strenght,0,0,0,1,1,#Div0,0.0,#Div0
gets,0,5,0,1,6,#Div0,0.0,#Div0
struggle,0,0,0,1,1,#Div0,0.0,#Div0
doors,0,1,0,1,2,#Div0,0.0,#Div0
insure,0,0,0,1,1,#Div0,0.0,#Div0
rewarded,0,0,0,1,1,#Div0,0.0,#Div0
roam,0,0,0,1,1,#Div0,0.0,#Div0
useful,0,26,0,1,27,#Div0,0.0,#Div0
concentrates,0,0,0,1,1,#Div0,0.0,#Div0
draw,0,1,0,1,2,#Div0,0.0,#Div0
settle,0,0,0,1,1,#Div0,0.0,#Div0
suit,0,1,0,1,2,#Div0,0.0,#Div0
contributes,0,0,0,1,1,#Div0,0.0,#Div0
floor,0,0,0,1,1,#Div0,0.0,#Div0
measure,0,0,0,2,2,#Div0,0.0,#Div0
defence,0,0,0,1,1,#Div0,0.0,#Div0
promenet,0,0,0,1,1,#Div0,0.0,#Div0
behind,0,1,0,6,7,#Div0,0.0,#Div0
or,0,392,0,1,393,#Div0,0.0,#Div0
semesters,0,0,0,1,1,#Div0,0.0,#Div0
Seeing,0,0,0,2,2,#Div0,0.0,#Div0
add,0,1,0,3,4,#Div0,0.0,#Div0
junk,0,0,0,2,2,#Div0,0.0,#Div0
misleading,0,0,0,3,3,#Div0,0.0,#Div0
thirst,0,0,0,1,1,#Div0,0.0,#Div0
cleary,0,0,0,1,1,#Div0,0.0,#Div0
One,0,13,0,1,14,#Div0,0.0,#Div0
perspective,0,2,0,1,3,#Div0,0.0,#Div0
wast,0,0,0,2,2,#Div0,0.0,#Div0
comparative,0,0,1,0,1,0.0,#Div0,#Div0
broader,0,0,0,6,6,#Div0,0.0,#Div0
turn,0,2,0,3,5,#Div0,0.0,#Div0
version,0,0,0,2,2,#Div0,0.0,#Div0
fast,0,7,0,2,9,#Div0,0.0,#Div0
lens,0,0,0,1,1,#Div0,0.0,#Div0
up,0,33,0,17,50,#Div0,0.0,#Div0
shine,0,0,0,2,2,#Div0,0.0,#Div0
send,0,1,0,1,2,#Div0,0.0,#Div0
control,0,3,0,2,5,#Div0,0.0,#Div0
established,0,3,0,3,6,#Div0,0.0,#Div0
work,0,95,2,4,101,0.0,0.0,#Div0
courage,0,6,0,1,7,#Div0,0.0,#Div0
discard,0,0,0,1,1,#Div0,0.0,#Div0
flexibility,0,0,0,2,2,#Div0,0.0,#Div0
semester,0,0,0,2,2,#Div0,0.0,#Div0
Advancement,0,0,0,1,1,#Div0,0.0,#Div0
shape,0,2,0,1,3,#Div0,0.0,#Div0
wasted,0,0,0,2,2,#Div0,0.0,#Div0
fit,0,0,0,2,2,#Div0,0.0,#Div0
diminish,0,1,0,1,2,#Div0,0.0,#Div0
explosion,0,0,0,1,1,#Div0,0.0,#Div0
endless,0,0,0,1,1,#Div0,0.0,#Div0
closer,0,0,0,1,1,#Div0,0.0,#Div0
stood,0,0,0,1,1,#Div0,0.0,#Div0
contained,0,0,0,1,1,#Div0,0.0,#Div0
precious,0,1,0,2,3,#Div0,0.0,#Div0
spot,0,0,0,1,1,#Div0,0.0,#Div0
fresh,0,2,0,2,4,#Div0,0.0,#Div0
promote,0,3,0,1,4,#Div0,0.0,#Div0
touch,0,1,0,3,4,#Div0,0.0,#Div0
boosted,0,0,0,1,1,#Div0,0.0,#Div0
busy,0,11,0,2,13,#Div0,0.0,#Div0
conduce,0,0,0,1,1,#Div0,0.0,#Div0
firmly,0,0,0,1,1,#Div0,0.0,#Div0
carried,0,0,0,1,1,#Div0,0.0,#Div0
building,0,5,0,1,6,#Div0,0.0,#Div0
fits,0,0,0,2,2,#Div0,0.0,#Div0
elderly,0,1,1,0,2,0.0,#Div0,#Div0
free,0,8,0,14,22,#Div0,0.0,#Div0
require,0,6,0,1,7,#Div0,0.0,#Div0
fullfilling,0,1,0,1,2,#Div0,0.0,#Div0
the,0,2383,0,20,2403,#Div0,0.0,#Div0
simple,0,8,0,1,9,#Div0,0.0,#Div0
out,0,46,0,9,55,#Div0,0.0,#Div0
advatages,0,0,0,1,1,#Div0,0.0,#Div0
achieved,0,3,0,1,4,#Div0,0.0,#Div0
demands,0,2,0,1,3,#Div0,0.0,#Div0
drop,0,0,0,2,2,#Div0,0.0,#Div0
wasting,0,0,0,2,2,#Div0,0.0,#Div0
analyze,0,2,1,0,3,0.0,#Div0,#Div0
eaten,0,0,0,1,1,#Div0,0.0,#Div0
old-men,0,0,0,1,1,#Div0,0.0,#Div0
calm,0,0,0,1,1,#Div0,0.0,#Div0
hidden,0,0,0,2,2,#Div0,0.0,#Div0
aspect,0,8,0,2,10,#Div0,0.0,#Div0
tied,0,0,0,1,1,#Div0,0.0,#Div0
dynamic,0,0,0,4,4,#Div0,0.0,#Div0
weight,0,1,0,1,2,#Div0,0.0,#Div0
richness,0,0,0,1,1,#Div0,0.0,#Div0
build,0,2,0,6,8,#Div0,0.0,#Div0
division,0,3,0,1,4,#Div0,0.0,#Div0
form,0,6,0,1,7,#Div0,0.0,#Div0
master,0,0,0,1,1,#Div0,0.0,#Div0
loss,0,1,0,2,3,#Div0,0.0,#Div0
age,0,21,0,2,23,#Div0,0.0,#Div0
environement,0,0,0,1,1,#Div0,0.0,#Div0
left,0,2,0,1,3,#Div0,0.0,#Div0
gave,0,6,0,3,9,#Div0,0.0,#Div0
sign,0,1,0,2,3,#Div0,0.0,#Div0
carries,0,0,0,1,1,#Div0,0.0,#Div0
damage,0,0,0,1,1,#Div0,0.0,#Div0
way,0,104,0,6,110,#Div0,0.0,#Div0
phases,0,0,0,1,1,#Div0,0.0,#Div0
coin,0,0,0,1,1,#Div0,0.0,#Div0
produce,0,7,0,1,8,#Div0,0.0,#Div0
advancing,0,0,0,1,1,#Div0,0.0,#Div0
surve,0,0,0,1,1,#Div0,0.0,#Div0
grown,0,1,0,2,3,#Div0,0.0,#Div0
tempted,0,0,0,1,1,#Div0,0.0,#Div0
leaving,0,2,0,2,4,#Div0,0.0,#Div0
carry,0,0,0,2,2,#Div0,0.0,#Div0
destination,0,2,0,1,3,#Div0,0.0,#Div0
higher,0,7,0,4,11,#Div0,0.0,#Div0
boundaries,0,0,0,1,1,#Div0,0.0,#Div0
hang,0,0,0,1,1,#Div0,0.0,#Div0
is,0,1023,0,1,1024,#Div0,0.0,#Div0
rule,0,1,0,1,2,#Div0,0.0,#Div0
overtaken,0,0,0,1,1,#Div0,0.0,#Div0
basing,0,0,0,1,1,#Div0,0.0,#Div0
deeper,0,0,0,5,5,#Div0,0.0,#Div0
litte,0,0,0,1,1,#Div0,0.0,#Div0
friendly,0,1,0,1,2,#Div0,0.0,#Div0
immerse,0,0,0,1,1,#Div0,0.0,#Div0
restriction,0,0,0,1,1,#Div0,0.0,#Div0
limitaions,0,0,0,1,1,#Div0,0.0,#Div0
actractivity,0,0,0,1,1,#Div0,0.0,#Div0
sources,0,3,0,2,5,#Div0,0.0,#Div0
surrounded,0,1,0,1,2,#Div0,0.0,#Div0
spent,0,1,0,3,4,#Div0,0.0,#Div0
children,0,25,0,1,26,#Div0,0.0,#Div0
stems,0,0,0,1,1,#Div0,0.0,#Div0
dicover,0,0,0,1,1,#Div0,0.0,#Div0
intruduced,0,0,0,1,1,#Div0,0.0,#Div0
create,0,8,0,2,10,#Div0,0.0,#Div0
playing,0,5,0,2,7,#Div0,0.0,#Div0
its,0,36,0,1,37,#Div0,0.0,#Div0
several,0,15,2,0,17,0.0,#Div0,#Div0
appriciate,0,0,0,3,3,#Div0,0.0,#Div0
loyalty,0,1,0,1,2,#Div0,0.0,#Div0
working,0,32,1,1,34,0.0,0.0,#Div0
collecting,0,0,0,1,1,#Div0,0.0,#Div0
repared,0,0,0,1,1,#Div0,0.0,#Div0
cool,0,2,0,1,3,#Div0,0.0,#Div0
changed,0,7,0,1,8,#Div0,0.0,#Div0
divided,0,0,0,1,1,#Div0,0.0,#Div0
pluck,0,0,0,1,1,#Div0,0.0,#Div0
eye,0,1,0,1,2,#Div0,0.0,#Div0
face,0,2,0,15,17,#Div0,0.0,#Div0
confident,0,3,0,1,4,#Div0,0.0,#Div0
pursuing,0,0,0,1,1,#Div0,0.0,#Div0
lost,0,10,0,2,12,#Div0,0.0,#Div0
spaces,0,0,0,1,1,#Div0,0.0,#Div0
core,0,1,0,3,4,#Div0,0.0,#Div0
healthier,0,0,0,1,1,#Div0,0.0,#Div0
born,0,3,0,2,5,#Div0,0.0,#Div0
call,0,6,1,0,7,0.0,#Div0,#Div0
mechanically,0,0,0,1,1,#Div0,0.0,#Div0
rush,0,0,0,1,1,#Div0,0.0,#Div0
outburst,0,0,0,1,1,#Div0,0.0,#Div0
weak,0,0,0,4,4,#Div0,0.0,#Div0
new,0,211,0,3,214,#Div0,0.0,#Div0
pains,0,0,0,1,1,#Div0,0.0,#Div0
leg,0,0,0,1,1,#Div0,0.0,#Div0
flexiblly,0,0,0,2,2,#Div0,0.0,#Div0
avoid,0,7,0,1,8,#Div0,0.0,#Div0
look,0,26,0,5,31,#Div0,0.0,#Div0
fantastic,0,1,0,1,2,#Div0,0.0,#Div0
attract,1,0,0,4,5,1.0,0.2,0.33333333333333337
broadn,0,0,0,1,1,#Div0,0.0,#Div0
role,0,8,0,1,9,#Div0,0.0,#Div0
suffer,0,0,0,1,1,#Div0,0.0,#Div0
smooth,0,0,0,1,1,#Div0,0.0,#Div0
meaningless,0,0,0,1,1,#Div0,0.0,#Div0
shrugged,0,0,0,1,1,#Div0,0.0,#Div0
against,0,6,0,1,7,#Div0,0.0,#Div0
stop,0,7,0,1,8,#Div0,0.0,#Div0
constraints,0,0,0,1,1,#Div0,0.0,#Div0
finding,0,2,0,1,3,#Div0,0.0,#Div0
trucks,0,0,0,1,1,#Div0,0.0,#Div0
virtue,0,0,0,1,1,#Div0,0.0,#Div0
Broad,0,0,0,1,1,#Div0,0.0,#Div0
fulfill,0,0,0,1,1,#Div0,0.0,#Div0
hassle,0,0,0,1,1,#Div0,0.0,#Div0
breaking,0,0,0,1,1,#Div0,0.0,#Div0
pass,0,1,0,1,2,#Div0,0.0,#Div0
search,0,5,1,1,7,0.0,0.0,#Div0
channels,0,0,0,1,1,#Div0,0.0,#Div0
confess,0,0,0,1,1,#Div0,0.0,#Div0
rising,0,0,0,1,1,#Div0,0.0,#Div0
intense,0,0,0,1,1,#Div0,0.0,#Div0
tons,0,0,0,1,1,#Div0,0.0,#Div0
powerfull,0,0,0,1,1,#Div0,0.0,#Div0
ranges,0,0,0,1,1,#Div0,0.0,#Div0
less,0,42,0,4,46,#Div0,0.0,#Div0
foretasted,0,0,0,1,1,#Div0,0.0,#Div0
demanding,0,0,0,1,1,#Div0,0.0,#Div0
resist,0,0,0,1,1,#Div0,0.0,#Div0
obstacle,0,0,0,2,2,#Div0,0.0,#Div0
supported,0,0,0,6,6,#Div0,0.0,#Div0
prepare,0,1,0,1,2,#Div0,0.0,#Div0
vertically,0,0,0,1,1,#Div0,0.0,#Div0
rough,0,1,0,1,2,#Div0,0.0,#Div0
blend,0,0,0,1,1,#Div0,0.0,#Div0
bare,0,0,0,1,1,#Div0,0.0,#Div0
driven,0,0,0,1,1,#Div0,0.0,#Div0
seize,0,0,0,1,1,#Div0,0.0,#Div0
see,0,55,0,5,60,#Div0,0.0,#Div0
revolution,0,0,0,3,3,#Div0,0.0,#Div0
ruining,0,0,0,4,4,#Div0,0.0,#Div0
many,0,200,20,0,220,0.0,#Div0,#Div0
range,0,8,0,1,9,#Div0,0.0,#Div0
coordinating,0,0,0,1,1,#Div0,0.0,#Div0
impression,0,7,0,1,8,#Div0,0.0,#Div0
limits,0,1,0,3,4,#Div0,0.0,#Div0
perspectives,0,0,0,2,2,#Div0,0.0,#Div0
ode,0,0,0,1,1,#Div0,0.0,#Div0
buy,0,42,0,1,43,#Div0,0.0,#Div0
emerge,0,0,0,1,1,#Div0,0.0,#Div0
key,0,1,0,3,4,#Div0,0.0,#Div0
Sorses,0,0,0,1,1,#Div0,0.0,#Div0
this,0,309,0,1,310,#Div0,0.0,#Div0
spreaded,0,0,0,1,1,#Div0,0.0,#Div0
primises,0,0,0,1,1,#Div0,0.0,#Div0
majority,0,1,0,1,2,#Div0,0.0,#Div0
catch,0,0,0,1,1,#Div0,0.0,#Div0
lack,0,5,0,2,7,#Div0,0.0,#Div0
conection,0,0,0,1,1,#Div0,0.0,#Div0
soft,0,0,0,1,1,#Div0,0.0,#Div0
aiming,0,0,0,1,1,#Div0,0.0,#Div0
comfortable,0,3,0,7,10,#Div0,0.0,#Div0
voices,0,0,0,1,1,#Div0,0.0,#Div0
stongly,0,0,0,2,2,#Div0,0.0,#Div0
attribute,0,0,0,1,1,#Div0,0.0,#Div0
connection,0,0,0,5,5,#Div0,0.0,#Div0
signs,0,0,0,1,1,#Div0,0.0,#Div0
cheat,0,0,0,1,1,#Div0,0.0,#Div0
stronger,0,1,0,2,3,#Div0,0.0,#Div0
getting,0,21,0,1,22,#Div0,0.0,#Div0
beatiful,0,0,0,1,1,#Div0,0.0,#Div0
whole,0,8,0,2,10,#Div0,0.0,#Div0
actively,0,1,0,1,2,#Div0,0.0,#Div0
dedicates,0,0,0,1,1,#Div0,0.0,#Div0
over,0,20,0,4,24,#Div0,0.0,#Div0
full,0,4,0,13,17,#Div0,0.0,#Div0
model,0,5,0,1,6,#Div0,0.0,#Div0
cover,0,1,0,2,3,#Div0,0.0,#Div0
experiment,0,4,0,1,5,#Div0,0.0,#Div0
intencity,0,0,0,2,2,#Div0,0.0,#Div0
use,0,88,0,3,91,#Div0,0.0,#Div0
expressing,0,1,0,1,2,#Div0,0.0,#Div0
enlargement,0,0,0,1,1,#Div0,0.0,#Div0
schocking,0,0,0,1,1,#Div0,0.0,#Div0
discover,0,2,0,5,7,#Div0,0.0,#Div0
formed,0,0,0,1,1,#Div0,0.0,#Div0
stages,0,0,0,2,2,#Div0,0.0,#Div0
flower,0,0,0,1,1,#Div0,0.0,#Div0
small,0,12,0,4,16,#Div0,0.0,#Div0
Use,0,0,0,1,1,#Div0,0.0,#Div0
availible,0,0,0,1,1,#Div0,0.0,#Div0
on,0,246,0,13,259,#Div0,0.0,#Div0
rejected,0,2,0,1,3,#Div0,0.0,#Div0
meet,0,14,0,3,17,#Div0,0.0,#Div0
class,0,17,0,1,18,#Div0,0.0,#Div0
surround,0,0,0,1,1,#Div0,0.0,#Div0
first,0,36,0,2,38,#Div0,0.0,#Div0
reflects,0,0,0,1,1,#Div0,0.0,#Div0
time,0,289,0,2,291,#Div0,0.0,#Div0
throwing,0,0,0,1,1,#Div0,0.0,#Div0
faces,0,0,0,3,3,#Div0,0.0,#Div0
useless,0,4,0,2,6,#Div0,0.0,#Div0
after,0,49,0,2,51,#Div0,0.0,#Div0
scratch,0,0,0,1,1,#Div0,0.0,#Div0
it,0,565,0,1,566,#Div0,0.0,#Div0
adventure,0,5,0,1,6,#Div0,0.0,#Div0
dragged,0,0,0,1,1,#Div0,0.0,#Div0
blast,0,0,0,1,1,#Div0,0.0,#Div0
safety,0,4,0,1,5,#Div0,0.0,#Div0
vanish,0,0,0,1,1,#Div0,0.0,#Div0
cut,0,2,0,1,3,#Div0,0.0,#Div0
nearer,0,0,0,1,1,#Div0,0.0,#Div0
deliver,0,0,0,1,1,#Div0,0.0,#Div0
distract,0,0,0,1,1,#Div0,0.0,#Div0
attracted,0,0,0,1,1,#Div0,0.0,#Div0
facing,0,0,0,2,2,#Div0,0.0,#Div0
comfortably,0,0,0,1,1,#Div0,0.0,#Div0
seek,0,0,0,2,2,#Div0,0.0,#Div0
access,0,1,0,2,3,#Div0,0.0,#Div0
stuffed,0,0,0,1,1,#Div0,0.0,#Div0
breakdown,0,0,0,1,1,#Div0,0.0,#Div0
opener,0,0,0,1,1,#Div0,0.0,#Div0
fat,0,0,1,0,1,0.0,#Div0,#Div0
used,0,37,0,2,39,#Div0,0.0,#Div0
brings,0,9,0,1,10,#Div0,0.0,#Div0
battles,0,0,0,1,1,#Div0,0.0,#Div0
upon,0,5,0,1,6,#Div0,0.0,#Div0
clear,0,3,0,7,10,#Div0,0.0,#Div0
person,0,131,0,1,132,#Div0,0.0,#Div0
roots,0,0,0,1,1,#Div0,0.0,#Div0
prized,0,0,0,1,1,#Div0,0.0,#Div0
struggling,0,0,0,1,1,#Div0,0.0,#Div0
money,0,60,0,1,61,#Div0,0.0,#Div0
come,0,19,1,1,21,0.0,0.0,#Div0
broad,0,0,0,56,56,#Div0,0.0,#Div0
outsiders,0,0,0,1,1,#Div0,0.0,#Div0
discovery,0,1,0,3,4,#Div0,0.0,#Div0
environment,0,14,0,1,15,#Div0,0.0,#Div0
relying,0,0,0,1,1,#Div0,0.0,#Div0
imposed,0,0,0,1,1,#Div0,0.0,#Div0
theory,0,8,0,1,9,#Div0,0.0,#Div0
fanatic,0,0,0,1,1,#Div0,0.0,#Div0
remain,0,2,0,2,4,#Div0,0.0,#Div0
places,0,43,0,1,44,#Div0,0.0,#Div0
arrive,0,1,1,0,2,0.0,#Div0,#Div0
light,0,3,0,2,5,#Div0,0.0,#Div0
spread-out,0,0,0,1,1,#Div0,0.0,#Div0
open,0,1,0,10,11,#Div0,0.0,#Div0
golden,0,0,0,1,1,#Div0,0.0,#Div0
end,0,9,0,2,11,#Div0,0.0,#Div0
pursue,0,0,0,2,2,#Div0,0.0,#Div0
telling,0,1,0,1,2,#Div0,0.0,#Div0
through,0,21,0,4,25,#Div0,0.0,#Div0
advantage,0,3,0,2,5,#Div0,0.0,#Div0
reflect,0,0,0,2,2,#Div0,0.0,#Div0
talk,0,15,4,0,19,0.0,#Div0,#Div0
path,0,1,0,4,5,#Div0,0.0,#Div0
secured,0,0,0,1,1,#Div0,0.0,#Div0
moves,0,1,0,1,2,#Div0,0.0,#Div0
runs,0,0,0,1,1,#Div0,0.0,#Div0
save,0,5,0,3,8,#Div0,0.0,#Div0
take,0,66,0,15,81,#Div0,0.0,#Div0
big,0,31,0,5,36,#Div0,0.0,#Div0
keep-it-safe,0,0,0,1,1,#Div0,0.0,#Div0
episodes,0,0,0,1,1,#Div0,0.0,#Div0
shed,0,0,0,1,1,#Div0,0.0,#Div0
flowing,0,0,0,1,1,#Div0,0.0,#Div0
down,0,4,0,2,6,#Div0,0.0,#Div0
senior,0,1,1,0,2,0.0,#Div0,#Div0
