token,tp_cases,fp_cases,tn_cases,fn_cases,total_cases,precision,recall,f1-score
common,0,4,1,0,5,0.0,#Div0,#Div0
handicaps,0,0,0,1,1,#Div0,0.0,#Div0
trail,0,0,0,1,1,#Div0,0.0,#Div0
powerful,0,5,3,0,8,0.0,#Div0,#Div0
pure,0,0,1,0,1,#Div0,#Div0,#Div0
hopeful,0,2,0,0,2,0.0,#Div0,#Div0
maims,0,0,0,1,1,#Div0,0.0,#Div0
representative,0,0,2,0,2,#Div0,#Div0,#Div0
substantial,0,1,0,0,1,0.0,#Div0,#Div0
fight,0,0,0,27,27,#Div0,0.0,#Div0
guerrilla-controlled,0,1,0,0,1,0.0,#Div0,#Div0
tiny,0,0,1,0,1,#Div0,#Div0,#Div0
unstable,0,1,0,0,1,0.0,#Div0,#Div0
credible,0,1,0,0,1,0.0,#Div0,#Div0
presidential,0,5,2,0,7,0.0,#Div0,#Div0
unattractive,0,1,0,0,1,0.0,#Div0,#Div0
republican,0,1,0,0,1,0.0,#Div0,#Div0
civilian,0,1,1,0,2,0.0,#Div0,#Div0
progressive,0,4,0,0,4,0.0,#Div0,#Div0
out,0,3,0,0,3,0.0,#Div0,#Div0
compelling,0,1,0,0,1,0.0,#Div0,#Div0
increased,0,0,1,2,3,#Div0,0.0,#Div0
executive,0,1,2,0,3,0.0,#Div0,#Div0
ridiculous,0,2,0,0,2,0.0,#Div0,#Div0
normal,0,0,1,0,1,#Div0,#Div0,#Div0
extracts,0,0,0,1,1,#Div0,0.0,#Div0
boiling,0,0,0,1,1,#Div0,0.0,#Div0
enough,0,1,1,0,2,0.0,#Div0,#Div0
billion-plus,0,0,1,0,1,#Div0,#Div0,#Div0
impoverished,0,1,0,0,1,0.0,#Div0,#Div0
defensive,0,1,0,0,1,0.0,#Div0,#Div0
long,0,4,2,0,6,0.0,#Div0,#Div0
unthinking,0,2,0,0,2,0.0,#Div0,#Div0
spineless,0,0,1,0,1,#Div0,#Div0,#Div0
Indian,0,0,1,0,1,#Div0,#Div0,#Div0
buys,0,0,0,1,1,#Div0,0.0,#Div0
Run-related,0,1,0,0,1,0.0,#Div0,#Div0
posthumous,0,1,0,0,1,0.0,#Div0,#Div0
electoral,0,1,0,0,1,0.0,#Div0,#Div0
decreased,0,0,0,2,2,#Div0,0.0,#Div0
tough,0,2,0,0,2,0.0,#Div0,#Div0
thin,0,0,1,0,1,#Div0,#Div0,#Div0
captures,0,0,0,2,2,#Div0,0.0,#Div0
guardian,0,0,0,4,4,#Div0,0.0,#Div0
robbing,0,0,0,1,1,#Div0,0.0,#Div0
bearish,0,2,0,0,2,0.0,#Div0,#Div0
catastrophic,0,1,0,0,1,0.0,#Div0,#Div0
following,0,0,1,0,1,#Div0,#Div0,#Div0
defeat,0,0,0,8,8,#Div0,0.0,#Div0
Killing,0,0,0,3,3,#Div0,0.0,#Div0
shape,0,0,0,2,2,#Div0,0.0,#Div0
invisible,0,2,0,0,2,0.0,#Div0,#Div0
better-off,0,1,0,0,1,0.0,#Div0,#Div0
Guardian,0,0,0,1,1,#Div0,0.0,#Div0
two-man,0,0,1,0,1,#Div0,#Div0,#Div0
reinforces,0,0,0,3,3,#Div0,0.0,#Div0
developing,0,2,0,0,2,0.0,#Div0,#Div0
whole,0,5,1,0,6,0.0,#Div0,#Div0
fine,0,0,0,2,2,#Div0,0.0,#Div0
dark,0,6,0,0,6,0.0,#Div0,#Div0
sweeping,0,1,1,0,2,0.0,#Div0,#Div0
circulation,0,0,0,2,2,#Div0,0.0,#Div0
struggle,0,0,0,1,1,#Div0,0.0,#Div0
practical,0,2,0,0,2,0.0,#Div0,#Div0
Team,0,0,1,0,1,#Div0,#Div0,#Div0
limited,0,3,1,0,4,0.0,#Div0,#Div0
statistical,0,0,2,0,2,#Div0,#Div0,#Div0
personal,0,5,3,0,8,0.0,#Div0,#Div0
disintegrated,0,0,0,1,1,#Div0,0.0,#Div0
feeds,0,0,0,1,1,#Div0,0.0,#Div0
scored,1,0,0,0,1,1.0,1.0,1.0
solo,0,1,0,0,1,0.0,#Div0,#Div0
corporate,0,4,3,0,7,0.0,#Div0,#Div0
M-4,0,1,0,0,1,0.0,#Div0,#Div0
victory,0,0,0,16,16,#Div0,0.0,#Div0
positive,0,1,1,0,2,0.0,#Div0,#Div0
limits,0,0,0,1,1,#Div0,0.0,#Div0
offers,0,0,0,1,1,#Div0,0.0,#Div0
harmful,0,3,0,0,3,0.0,#Div0,#Div0
advanced,0,0,0,4,4,#Div0,0.0,#Div0
walls,0,0,0,1,1,#Div0,0.0,#Div0
Other,0,1,1,0,2,0.0,#Div0,#Div0
additional,0,5,0,0,5,0.0,#Div0,#Div0
hole,0,0,0,3,3,#Div0,0.0,#Div0
significant,0,3,0,0,3,0.0,#Div0,#Div0
Arab,0,1,1,0,2,0.0,#Div0,#Div0
human right,0,0,0,1,1,#Div0,0.0,#Div0
defrauding,0,0,0,1,1,#Div0,0.0,#Div0
social,0,26,4,0,30,0.0,#Div0,#Div0
Public,0,0,1,0,1,#Div0,#Div0,#Div0
anti,0,8,1,0,9,0.0,#Div0,#Div0
heavy,0,0,3,0,3,#Div0,#Div0,#Div0
broad,0,0,1,0,1,#Div0,#Div0,#Div0
procedural,0,1,0,0,1,0.0,#Div0,#Div0
best-known,0,1,0,0,1,0.0,#Div0,#Div0
non-repayable,0,1,0,0,1,0.0,#Div0,#Div0
evolution,0,0,0,1,1,#Div0,0.0,#Div0
courageous,0,1,0,0,1,0.0,#Div0,#Div0
attacking,0,0,0,8,8,#Div0,0.0,#Div0
reduced,0,1,0,2,3,0.0,0.0,#Div0
public,0,16,9,0,25,0.0,#Div0,#Div0
moral,0,1,0,0,1,0.0,#Div0,#Div0
overdosed,0,0,0,1,1,#Div0,0.0,#Div0
punishment,0,0,0,1,1,#Div0,0.0,#Div0
terrorist,0,0,2,0,2,#Div0,#Div0,#Div0
continued,0,1,0,0,1,0.0,#Div0,#Div0
omnibus,0,2,0,0,2,0.0,#Div0,#Div0
numbing,0,0,1,0,1,#Div0,#Div0,#Div0
cerebral,0,1,0,0,1,0.0,#Div0,#Div0
obey,0,0,0,1,1,#Div0,0.0,#Div0
English,0,1,0,0,1,0.0,#Div0,#Div0
bilateral,0,0,1,0,1,#Div0,#Div0,#Div0
Hastily-passed,0,2,0,0,2,0.0,#Div0,#Div0
gun-discarding,0,1,0,0,1,0.0,#Div0,#Div0
idols,0,0,0,2,2,#Div0,0.0,#Div0
consecutive,0,1,0,0,1,0.0,#Div0,#Div0
restrain,0,0,0,1,1,#Div0,0.0,#Div0
slowed,0,0,2,0,2,#Div0,#Div0,#Div0
straight,0,1,0,0,1,0.0,#Div0,#Div0
Saudi,0,1,0,0,1,0.0,#Div0,#Div0
shaped,0,0,0,1,1,#Div0,0.0,#Div0
outside,0,1,2,0,3,0.0,#Div0,#Div0
Tackling,0,0,0,1,1,#Div0,0.0,#Div0
shield,0,0,0,6,6,#Div0,0.0,#Div0
addict,0,0,0,1,1,#Div0,0.0,#Div0
lit,0,1,0,0,1,0.0,#Div0,#Div0
classic,0,2,0,0,2,0.0,#Div0,#Div0
armed,0,1,3,0,4,0.0,#Div0,#Div0
direct,0,5,2,0,7,0.0,#Div0,#Div0
big,0,10,6,0,16,0.0,#Div0,#Div0
pre-empty,0,0,1,0,1,#Div0,#Div0,#Div0
profound,0,1,0,0,1,0.0,#Div0,#Div0
oppressive,2,0,0,0,2,1.0,1.0,1.0
racial,0,0,1,0,1,#Div0,#Div0,#Div0
assist,0,0,0,2,2,#Div0,0.0,#Div0
bold,0,1,0,0,1,0.0,#Div0,#Div0
county-level,0,1,0,0,1,0.0,#Div0,#Div0
operates,0,0,0,1,1,#Div0,0.0,#Div0
notable,0,0,1,0,1,#Div0,#Div0,#Div0
alone,0,2,0,0,2,0.0,#Div0,#Div0
curricular,0,0,1,0,1,#Div0,#Div0,#Div0
perverse,0,1,0,0,1,0.0,#Div0,#Div0
equitable,0,1,0,0,1,0.0,#Div0,#Div0
judicial,0,3,0,0,3,0.0,#Div0,#Div0
beautiful,0,1,0,0,1,0.0,#Div0,#Div0
fighting,0,0,0,24,24,#Div0,0.0,#Div0
remedy,0,0,0,1,1,#Div0,0.0,#Div0
barrier,0,0,0,1,1,#Div0,0.0,#Div0
junior-level,0,1,0,0,1,0.0,#Div0,#Div0
nonpartisan,0,1,0,0,1,0.0,#Div0,#Div0
illuminates,0,0,0,4,4,#Div0,0.0,#Div0
effective,0,1,0,0,1,0.0,#Div0,#Div0
humane,0,0,1,0,1,#Div0,#Div0,#Div0
Lebanese,0,2,0,0,2,0.0,#Div0,#Div0
next,0,4,1,0,5,0.0,#Div0,#Div0
deep,0,1,0,0,1,0.0,#Div0,#Div0
would-be,0,1,0,0,1,0.0,#Div0,#Div0
relative,0,1,0,0,1,0.0,#Div0,#Div0
lifelong,0,1,0,0,1,0.0,#Div0,#Div0
leading,0,1,1,0,2,0.0,#Div0,#Div0
season,0,0,0,3,3,#Div0,0.0,#Div0
Equatorial,0,1,0,0,1,0.0,#Div0,#Div0
last,0,24,0,0,24,0.0,#Div0,#Div0
engenders,0,0,0,1,1,#Div0,0.0,#Div0
various,0,4,0,0,4,0.0,#Div0,#Div0
achievement,0,0,1,0,1,#Div0,#Div0,#Div0
elementary,0,3,0,0,3,0.0,#Div0,#Div0
dire,0,0,1,0,1,#Div0,#Div0,#Div0
national,0,10,4,0,14,0.0,#Div0,#Div0
prevent,0,1,0,0,1,0.0,#Div0,#Div0
irrational,0,1,0,0,1,0.0,#Div0,#Div0
stray,0,1,0,0,1,0.0,#Div0,#Div0
competition,0,0,0,3,3,#Div0,0.0,#Div0
worshippers,0,0,0,1,1,#Div0,0.0,#Div0
failure,0,0,0,1,1,#Div0,0.0,#Div0
slave,0,0,3,0,3,#Div0,#Div0,#Div0
first-world,0,0,1,0,1,#Div0,#Div0,#Div0
born,0,0,0,2,2,#Div0,0.0,#Div0
river,0,0,0,2,2,#Div0,0.0,#Div0
supporting,0,0,0,1,1,#Div0,0.0,#Div0
victimizes,0,0,0,2,2,#Div0,0.0,#Div0
exact,0,1,1,0,2,0.0,#Div0,#Div0
hard,0,1,1,0,2,0.0,#Div0,#Div0
limited-government,0,1,0,0,1,0.0,#Div0,#Div0
Congressional,0,1,0,0,1,0.0,#Div0,#Div0
multiple,0,0,1,0,1,#Div0,#Div0,#Div0
races,0,0,0,1,1,#Div0,0.0,#Div0
pretax,0,1,0,0,1,0.0,#Div0,#Div0
death,0,0,0,3,3,#Div0,0.0,#Div0
called,0,1,0,0,1,0.0,#Div0,#Div0
same,0,18,4,0,22,0.0,#Div0,#Div0
exacting,0,0,0,1,1,#Div0,0.0,#Div0
general,0,7,1,0,8,0.0,#Div0,#Div0
government-induced,0,1,0,0,1,0.0,#Div0,#Div0
Japanese,0,0,1,0,1,#Div0,#Div0,#Div0
business,0,0,0,1,1,#Div0,0.0,#Div0
serious,0,2,0,0,2,0.0,#Div0,#Div0
path,0,0,0,2,2,#Div0,0.0,#Div0
intelligent,0,1,1,0,2,0.0,#Div0,#Div0
gubernatorial,0,1,0,0,1,0.0,#Div0,#Div0
pothole,0,0,1,0,1,#Div0,#Div0,#Div0
petulant,0,1,0,0,1,0.0,#Div0,#Div0
structure,0,0,0,1,1,#Div0,0.0,#Div0
greases,0,0,0,1,1,#Div0,0.0,#Div0
tragedy,0,0,0,1,1,#Div0,0.0,#Div0
purchase,0,0,0,1,1,#Div0,0.0,#Div0
resist,0,0,0,2,2,#Div0,0.0,#Div0
fat,0,0,2,0,2,#Div0,#Div0,#Div0
subservient,0,1,0,0,1,0.0,#Div0,#Div0
capitalist,0,2,0,0,2,0.0,#Div0,#Div0
fresh,0,1,0,0,1,0.0,#Div0,#Div0
round up,0,0,0,1,1,#Div0,0.0,#Div0
barriers,0,0,0,1,1,#Div0,0.0,#Div0
countless,0,1,0,0,1,0.0,#Div0,#Div0
peculiar,0,1,0,0,1,0.0,#Div0,#Div0
untouchable,0,1,0,0,1,0.0,#Div0,#Div0
performative,0,1,0,0,1,0.0,#Div0,#Div0
destroys,0,0,0,2,2,#Div0,0.0,#Div0
duel,0,0,0,1,1,#Div0,0.0,#Div0
branches,0,0,0,1,1,#Div0,0.0,#Div0
retired,0,2,0,0,2,0.0,#Div0,#Div0
crisp,0,0,1,0,1,#Div0,#Div0,#Div0
shallow,0,0,1,0,1,#Div0,#Div0,#Div0
experimented,0,0,0,4,4,#Div0,0.0,#Div0
assault,0,0,0,3,3,#Div0,0.0,#Div0
modest,0,1,0,0,1,0.0,#Div0,#Div0
endangers,0,0,0,1,1,#Div0,0.0,#Div0
come,0,2,0,0,2,0.0,#Div0,#Div0
ten,0,0,1,0,1,#Div0,#Div0,#Div0
alleviation,0,0,0,2,2,#Div0,0.0,#Div0
coordinated,0,0,1,0,1,#Div0,#Div0,#Div0
Defeats,0,0,0,1,1,#Div0,0.0,#Div0
sizable,0,1,0,0,1,0.0,#Div0,#Div0
startling,0,0,2,0,2,#Div0,#Div0,#Div0
curtailed,0,1,0,0,1,0.0,#Div0,#Div0
internal,0,0,4,0,4,#Div0,#Div0,#Div0
astute,0,1,0,0,1,0.0,#Div0,#Div0
pretty,0,1,0,0,1,0.0,#Div0,#Div0
voracious,0,1,0,0,1,0.0,#Div0,#Div0
strategic,0,0,2,0,2,#Div0,#Div0,#Div0
growth,0,0,0,2,2,#Div0,0.0,#Div0
fat cat,0,0,0,1,1,#Div0,0.0,#Div0
desirable,0,2,0,0,2,0.0,#Div0,#Div0
community,0,0,0,1,1,#Div0,0.0,#Div0
killed,0,0,0,4,4,#Div0,0.0,#Div0
face,0,0,0,3,3,#Div0,0.0,#Div0
reverenced,0,1,0,0,1,0.0,#Div0,#Div0
sell,0,0,0,1,1,#Div0,0.0,#Div0
happiness,0,1,0,0,1,0.0,#Div0,#Div0
Assyrian,0,1,1,0,2,0.0,#Div0,#Div0
unchecked,0,1,0,0,1,0.0,#Div0,#Div0
infests,0,0,0,2,2,#Div0,0.0,#Div0
eventual,0,1,0,0,1,0.0,#Div0,#Div0
past,0,4,0,0,4,0.0,#Div0,#Div0
victories,0,0,0,1,1,#Div0,0.0,#Div0
retreated,0,0,0,1,1,#Div0,0.0,#Div0
storm,0,0,0,2,2,#Div0,0.0,#Div0
moronic,0,1,0,0,1,0.0,#Div0,#Div0
dangerous,2,1,3,0,6,0.6666666666666666,1.0,0.8
Draconian,0,3,0,0,3,0.0,#Div0,#Div0
nimrod,0,2,0,0,2,0.0,#Div0,#Div0
protectionist,0,1,0,0,1,0.0,#Div0,#Div0
plastic,0,0,1,0,1,#Div0,#Div0,#Div0
nominal,0,1,0,0,1,0.0,#Div0,#Div0
capture,0,0,0,1,1,#Div0,0.0,#Div0
good,0,15,0,0,15,0.0,#Div0,#Div0
carnal,0,0,1,0,1,#Div0,#Div0,#Div0
radical,0,1,0,0,1,0.0,#Div0,#Div0
South,0,0,1,0,1,#Div0,#Div0,#Div0
simple,0,1,3,0,4,0.0,#Div0,#Div0
affirmative,0,2,0,0,2,0.0,#Div0,#Div0
unimaginable,0,1,0,0,1,0.0,#Div0,#Div0
firearm,0,0,6,0,6,#Div0,#Div0,#Div0
apple-red,0,0,1,0,1,#Div0,#Div0,#Div0
sustainable,0,1,0,0,1,0.0,#Div0,#Div0
resisted,0,0,0,2,2,#Div0,0.0,#Div0
elected,0,1,0,0,1,0.0,#Div0,#Div0
generous,0,2,0,0,2,0.0,#Div0,#Div0
strengthen,0,0,0,11,11,#Div0,0.0,#Div0
second-wave,0,0,2,0,2,#Div0,#Div0,#Div0
chronic,0,1,0,0,1,0.0,#Div0,#Div0
football,0,0,0,1,1,#Div0,0.0,#Div0
underhand,0,1,0,0,1,0.0,#Div0,#Div0
fellow,0,2,0,0,2,0.0,#Div0,#Div0
minor,0,0,2,0,2,#Div0,#Div0,#Div0
system,0,0,0,4,4,#Div0,0.0,#Div0
spread,0,0,1,0,1,#Div0,#Div0,#Div0
heated,0,1,0,0,1,0.0,#Div0,#Div0
humanitarian,0,1,0,0,1,0.0,#Div0,#Div0
increasing,0,0,0,1,1,#Div0,0.0,#Div0
distinct,0,1,0,0,1,0.0,#Div0,#Div0
extracted,0,0,0,1,1,#Div0,0.0,#Div0
likely,0,3,0,0,3,0.0,#Div0,#Div0
militaristic,0,1,0,0,1,0.0,#Div0,#Div0
human,0,2,14,0,16,0.0,#Div0,#Div0
urban,0,0,1,0,1,#Div0,#Div0,#Div0
fundamental,0,2,1,0,3,0.0,#Div0,#Div0
robs,0,0,0,5,5,#Div0,0.0,#Div0
defend,0,0,0,4,4,#Div0,0.0,#Div0
feeding,0,0,0,1,1,#Div0,0.0,#Div0
Democratic,0,6,4,0,10,0.0,#Div0,#Div0
decrease,0,0,0,3,3,#Div0,0.0,#Div0
iron-fitted,0,1,0,0,1,0.0,#Div0,#Div0
strong,0,5,1,0,6,0.0,#Div0,#Div0
create,0,0,0,2,2,#Div0,0.0,#Div0
beneficial,0,2,0,0,2,0.0,#Div0,#Div0
major,0,4,5,0,9,0.0,#Div0,#Div0
Several,0,4,1,0,5,0.0,#Div0,#Div0
right-wing,0,2,0,0,2,0.0,#Div0,#Div0
small,0,8,0,0,8,0.0,#Div0,#Div0
Colorado-based,0,2,0,0,2,0.0,#Div0,#Div0
arthritic,0,0,0,4,4,#Div0,0.0,#Div0
jeopardizes,0,0,0,1,1,#Div0,0.0,#Div0
evil,9,4,2,5,20,0.6923076923076923,0.6428571428571429,0.6666666666666666
glorify,0,0,0,1,1,#Div0,0.0,#Div0
environmental,0,0,1,0,1,#Div0,#Div0,#Div0
affected,0,1,0,0,1,0.0,#Div0,#Div0
breeze,0,0,0,1,1,#Div0,0.0,#Div0
uprooted,0,0,1,0,1,#Div0,#Div0,#Div0
hated,0,1,0,0,1,0.0,#Div0,#Div0
communist,0,2,0,0,2,0.0,#Div0,#Div0
inexplicably,0,1,0,0,1,0.0,#Div0,#Div0
reverse,0,1,0,0,1,0.0,#Div0,#Div0
tortuous,0,2,0,0,2,0.0,#Div0,#Div0
legal,0,3,0,0,3,0.0,#Div0,#Div0
foreign,0,9,0,0,9,0.0,#Div0,#Div0
economic,0,22,7,0,29,0.0,#Div0,#Div0
universal,0,1,0,0,1,0.0,#Div0,#Div0
travels,0,0,0,1,1,#Div0,0.0,#Div0
snuffs out,0,0,0,3,3,#Div0,0.0,#Div0
retail,0,1,1,0,2,0.0,#Div0,#Div0
dominate,0,0,0,1,1,#Div0,0.0,#Div0
ordinary,0,2,0,0,2,0.0,#Div0,#Div0
protected,0,0,0,1,1,#Div0,0.0,#Div0
smooth,0,2,0,0,2,0.0,#Div0,#Div0
silly,0,5,0,0,5,0.0,#Div0,#Div0
dominant,0,2,0,0,2,0.0,#Div0,#Div0
coherent,0,0,1,0,1,#Div0,#Div0,#Div0
scary,0,3,0,0,3,0.0,#Div0,#Div0
Lent,0,0,1,0,1,#Div0,#Div0,#Div0
pillar,0,0,0,2,2,#Div0,0.0,#Div0
artful,0,1,0,0,1,0.0,#Div0,#Div0
illicit,0,1,0,0,1,0.0,#Div0,#Div0
unlimited,0,1,0,0,1,0.0,#Div0,#Div0
African,0,0,2,0,2,#Div0,#Div0,#Div0
prior,0,1,0,0,1,0.0,#Div0,#Div0
parliamentary,0,3,0,0,3,0.0,#Div0,#Div0
ministerial,0,2,0,0,2,0.0,#Div0,#Div0
educational,0,1,1,0,2,0.0,#Div0,#Div0
integral,0,1,0,0,1,0.0,#Div0,#Div0
several,0,3,1,0,4,0.0,#Div0,#Div0
supporter,0,0,0,1,1,#Div0,0.0,#Div0
corrective,0,1,0,0,1,0.0,#Div0,#Div0
uncertain,0,1,0,0,1,0.0,#Div0,#Div0
visual,0,0,1,0,1,#Div0,#Div0,#Div0
invasion,0,0,0,6,6,#Div0,0.0,#Div0
collapse,0,0,0,7,7,#Div0,0.0,#Div0
rigid,0,0,1,0,1,#Div0,#Div0,#Div0
mindless,0,2,0,0,2,0.0,#Div0,#Div0
trillion-dollar,0,1,0,0,1,0.0,#Div0,#Div0
fought,0,0,0,2,2,#Div0,0.0,#Div0
monarchical,0,0,1,0,1,#Div0,#Div0,#Div0
illegal,0,5,0,0,5,0.0,#Div0,#Div0
helpless,0,2,0,0,2,0.0,#Div0,#Div0
Democrat-controlled,0,1,0,0,1,0.0,#Div0,#Div0
region-wide,0,2,0,0,2,0.0,#Div0,#Div0
voluntary,0,5,0,0,5,0.0,#Div0,#Div0
anti-communist,0,0,2,0,2,#Div0,#Div0,#Div0
preferred,0,2,0,0,2,0.0,#Div0,#Div0
increase,0,0,0,6,6,#Div0,0.0,#Div0
obvious,0,1,0,0,1,0.0,#Div0,#Div0
comprehensive,0,3,0,0,3,0.0,#Div0,#Div0
rain,0,0,0,2,2,#Div0,0.0,#Div0
feminist,0,2,0,0,2,0.0,#Div0,#Div0
Asian,0,0,2,0,2,#Div0,#Div0,#Div0
business-model,0,0,3,0,3,#Div0,#Div0,#Div0
rights-because,0,3,0,0,3,0.0,#Div0,#Div0
pivotal,0,2,0,0,2,0.0,#Div0,#Div0
utilitarian,0,0,1,0,1,#Div0,#Div0,#Div0
few,0,6,3,0,9,0.0,#Div0,#Div0
double,0,0,4,0,4,#Div0,#Div0,#Div0
drama,0,0,0,1,1,#Div0,0.0,#Div0
average,0,1,0,0,1,0.0,#Div0,#Div0
bureaucratic,0,2,0,0,2,0.0,#Div0,#Div0
*,0,3,0,0,3,0.0,#Div0,#Div0
median,0,0,2,0,2,#Div0,#Div0,#Div0
robbed,0,0,0,1,1,#Div0,0.0,#Div0
perfect,0,3,0,0,3,0.0,#Div0,#Div0
proactive,0,1,0,0,1,0.0,#Div0,#Div0
fair,0,1,0,0,1,0.0,#Div0,#Div0
idiotic,0,3,0,0,3,0.0,#Div0,#Div0
deepen,0,0,0,2,2,#Div0,0.0,#Div0
wars,0,0,0,1,1,#Div0,0.0,#Div0
original,0,2,0,0,2,0.0,#Div0,#Div0
full,0,0,3,0,3,#Div0,#Div0,#Div0
equal,0,3,0,0,3,0.0,#Div0,#Div0
gun-nut,0,0,2,0,2,#Div0,#Div0,#Div0
modern,0,3,1,0,4,0.0,#Div0,#Div0
socialized,0,1,0,0,1,0.0,#Div0,#Div0
separate,0,2,0,0,2,0.0,#Div0,#Div0
ever-increasing,0,1,0,0,1,0.0,#Div0,#Div0
produces,0,0,0,3,3,#Div0,0.0,#Div0
self-defense,0,0,1,0,1,#Div0,#Div0,#Div0
oppresses,0,0,0,3,3,#Div0,0.0,#Div0
unite,0,1,0,0,1,0.0,#Div0,#Div0
outspoken,0,1,0,0,1,0.0,#Div0,#Div0
unethical,0,1,0,0,1,0.0,#Div0,#Div0
post-how,0,0,1,0,1,#Div0,#Div0,#Div0
flinty,0,1,0,0,1,0.0,#Div0,#Div0
left,0,4,0,0,4,0.0,#Div0,#Div0
statewide,0,3,0,0,3,0.0,#Div0,#Div0
burdens,0,0,0,5,5,#Div0,0.0,#Div0
absolutist,0,1,0,0,1,0.0,#Div0,#Div0
insignificant,0,1,0,0,1,0.0,#Div0,#Div0
nibbled,0,0,1,0,1,#Div0,#Div0,#Div0
strengthening,0,0,0,10,10,#Div0,0.0,#Div0
cure,0,0,0,7,7,#Div0,0.0,#Div0
damage,0,0,0,4,4,#Div0,0.0,#Div0
private,0,9,9,0,18,0.0,#Div0,#Div0
story,0,0,0,1,1,#Div0,0.0,#Div0
angry,0,3,0,0,3,0.0,#Div0,#Div0
unqualified,0,0,1,0,1,#Div0,#Div0,#Div0
guns,0,0,1,0,1,#Div0,#Div0,#Div0
rocky,0,0,1,0,1,#Div0,#Div0,#Div0
specific,0,1,0,0,1,0.0,#Div0,#Div0
rob,0,0,0,3,3,#Div0,0.0,#Div0
feudal,0,0,1,0,1,#Div0,#Div0,#Div0
clean,0,0,1,0,1,#Div0,#Div0,#Div0
pathway,0,0,0,1,1,#Div0,0.0,#Div0
wide,0,0,2,0,2,#Div0,#Div0,#Div0
reduce,0,0,0,5,5,#Div0,0.0,#Div0
contemplate,0,1,0,0,1,0.0,#Div0,#Div0
criminal,0,2,1,0,3,0.0,#Div0,#Div0
defeating,0,0,0,1,1,#Div0,0.0,#Div0
burdened,0,0,0,1,1,#Div0,0.0,#Div0
illegitimate,0,1,0,0,1,0.0,#Div0,#Div0
pro,0,6,2,0,8,0.0,#Div0,#Div0
Bolivian,0,0,1,0,1,#Div0,#Div0,#Div0
imperial,0,4,1,0,5,0.0,#Div0,#Div0
operations,0,0,0,1,1,#Div0,0.0,#Div0
amazing,0,1,0,0,1,0.0,#Div0,#Div0
informal,0,1,0,0,1,0.0,#Div0,#Div0
taxable,0,3,0,0,3,0.0,#Div0,#Div0
non,0,1,0,0,1,0.0,#Div0,#Div0
Islamic,0,1,1,0,2,0.0,#Div0,#Div0
minimum,0,2,0,0,2,0.0,#Div0,#Div0
multi-faceted,0,0,1,0,1,#Div0,#Div0,#Div0
regulation,0,0,0,1,1,#Div0,0.0,#Div0
top,0,0,5,0,5,#Div0,#Div0,#Div0
overcame,0,0,0,1,1,#Div0,0.0,#Div0
horrendous,0,2,0,0,2,0.0,#Div0,#Div0
smart,0,3,0,0,3,0.0,#Div0,#Div0
Israeli,0,2,0,0,2,0.0,#Div0,#Div0
similar,0,0,2,0,2,#Div0,#Div0,#Div0
addiction,0,0,0,8,8,#Div0,0.0,#Div0
free,0,10,2,0,12,0.0,#Div0,#Div0
possible,0,3,0,0,3,0.0,#Div0,#Div0
upper,0,3,0,0,3,0.0,#Div0,#Div0
oval,0,1,0,0,1,0.0,#Div0,#Div0
ersatz-democracy,0,1,0,0,1,0.0,#Div0,#Div0
productive,0,6,0,0,6,0.0,#Div0,#Div0
tide,0,0,0,2,2,#Div0,0.0,#Div0
assault-weapon,0,1,0,0,1,0.0,#Div0,#Div0
buy,0,0,0,1,1,#Div0,0.0,#Div0
ardent,0,0,1,0,1,#Div0,#Div0,#Div0
bogus,0,3,0,0,3,0.0,#Div0,#Div0
dark days,0,0,0,3,3,#Div0,0.0,#Div0
shaping,0,0,0,3,3,#Div0,0.0,#Div0
lucky,0,1,0,0,1,0.0,#Div0,#Div0
law-abiding,0,2,0,0,2,0.0,#Div0,#Div0
insufficient,0,1,0,0,1,0.0,#Div0,#Div0
permanent,0,1,2,0,3,0.0,#Div0,#Div0
Heinous,0,0,1,0,1,#Div0,#Div0,#Div0
depth,0,0,0,2,2,#Div0,0.0,#Div0
heals,0,0,0,3,3,#Div0,0.0,#Div0
worship,0,0,0,15,15,#Div0,0.0,#Div0
pose,0,0,1,0,1,#Div0,#Div0,#Div0
second,0,0,7,0,7,#Div0,#Div0,#Div0
defraud,0,0,0,1,1,#Div0,0.0,#Div0
judicious,0,1,0,0,1,0.0,#Div0,#Div0
extraordinary,0,1,0,0,1,0.0,#Div0,#Div0
race,0,0,0,1,1,#Div0,0.0,#Div0
primitive,0,1,1,0,2,0.0,#Div0,#Div0
easy,0,1,0,0,1,0.0,#Div0,#Div0
depths,0,0,0,3,3,#Div0,0.0,#Div0
malicious,0,0,1,0,1,#Div0,#Div0,#Div0
systemic,0,1,0,0,1,0.0,#Div0,#Div0
basic,0,2,4,0,6,0.0,#Div0,#Div0
devastation,0,0,0,5,5,#Div0,0.0,#Div0
cognitive,0,1,0,0,1,0.0,#Div0,#Div0
enhance,0,0,0,2,2,#Div0,0.0,#Div0
imaginary,0,1,0,0,1,0.0,#Div0,#Div0
Representative,0,0,4,0,4,#Div0,#Div0,#Div0
experiment,0,0,0,2,2,#Div0,0.0,#Div0
international,0,13,1,0,14,0.0,#Div0,#Div0
longtime,0,1,1,0,2,0.0,#Div0,#Div0
Governmental,0,1,0,0,1,0.0,#Div0,#Div0
medicinal,0,1,0,0,1,0.0,#Div0,#Div0
High,0,0,1,0,1,#Div0,#Div0,#Div0
prudent,0,1,0,0,1,0.0,#Div0,#Div0
giant,0,0,1,0,1,#Div0,#Div0,#Div0
almighty,0,1,0,0,1,0.0,#Div0,#Div0
harms,0,0,0,1,1,#Div0,0.0,#Div0
weak,0,1,0,0,1,0.0,#Div0,#Div0
victim,0,0,0,2,2,#Div0,0.0,#Div0
sea,0,0,0,2,2,#Div0,0.0,#Div0
alleviates,0,0,0,7,7,#Div0,0.0,#Div0
aka,0,1,0,0,1,0.0,#Div0,#Div0
spent,0,1,0,0,1,0.0,#Div0,#Div0
appetites,0,0,0,1,1,#Div0,0.0,#Div0
underfunded,0,1,0,0,1,0.0,#Div0,#Div0
four-trillion-dollar,0,0,2,0,2,#Div0,#Div0,#Div0
pro-gun,0,2,4,0,6,0.0,#Div0,#Div0
poverty,0,1,0,0,1,0.0,#Div0,#Div0
monthly,0,0,1,0,1,#Div0,#Div0,#Div0
ineffective,0,2,0,0,2,0.0,#Div0,#Div0
structural,0,0,1,0,1,#Div0,#Div0,#Div0
protection,0,0,0,1,1,#Div0,0.0,#Div0
due,0,1,0,0,1,0.0,#Div0,#Div0
ultra-meg-millionaire,0,1,0,0,1,0.0,#Div0,#Div0
burden,1,0,0,5,6,1.0,0.16666666666666666,0.2857142857142857
nineteenth,0,0,4,0,4,#Div0,#Div0,#Div0
unexpected,0,3,0,0,3,0.0,#Div0,#Div0
manufactured,0,0,0,1,1,#Div0,0.0,#Div0
punish,0,0,0,2,2,#Div0,0.0,#Div0
enable,0,1,0,0,1,0.0,#Div0,#Div0
certain,0,1,0,0,1,0.0,#Div0,#Div0
public-spirited,0,0,1,0,1,#Div0,#Div0,#Div0
destroy,0,0,0,11,11,#Div0,0.0,#Div0
contest,0,0,0,1,1,#Div0,0.0,#Div0
perceived,0,1,0,0,1,0.0,#Div0,#Div0
pointless,0,1,0,0,1,0.0,#Div0,#Div0
low,0,2,0,0,2,0.0,#Div0,#Div0
symbolic,0,1,0,0,1,0.0,#Div0,#Div0
Chinese,0,1,2,0,3,0.0,#Div0,#Div0
upon,0,2,0,0,2,0.0,#Div0,#Div0
high-handed,0,1,0,0,1,0.0,#Div0,#Div0
inadequate,0,1,0,0,1,0.0,#Div0,#Div0
hyper,0,2,0,0,2,0.0,#Div0,#Div0
rape,0,0,0,1,1,#Div0,0.0,#Div0
previous,0,3,0,0,3,0.0,#Div0,#Div0
greases the wheels,0,0,0,1,1,#Div0,0.0,#Div0
late,0,1,0,0,1,0.0,#Div0,#Div0
vehicle,0,0,0,3,3,#Div0,0.0,#Div0
strengthened,0,0,0,3,3,#Div0,0.0,#Div0
principal,0,0,3,0,3,#Div0,#Div0,#Div0
foundation,0,0,0,2,2,#Div0,0.0,#Div0
Liberal,0,1,2,0,3,0.0,#Div0,#Div0
threatened,0,0,0,1,1,#Div0,0.0,#Div0
battle,0,0,0,12,12,#Div0,0.0,#Div0
tailored,0,0,0,1,1,#Div0,0.0,#Div0
working,0,2,0,0,2,0.0,#Div0,#Div0
Ecuador,0,1,0,0,1,0.0,#Div0,#Div0
quest,0,0,0,3,3,#Div0,0.0,#Div0
victims,0,0,0,3,3,#Div0,0.0,#Div0
oral,0,0,1,0,1,#Div0,#Div0,#Div0
self-righteous,0,3,0,0,3,0.0,#Div0,#Div0
retreats,0,0,0,1,1,#Div0,0.0,#Div0
terroristic,0,2,0,0,2,0.0,#Div0,#Div0
sexual,0,0,1,0,1,#Div0,#Div0,#Div0
fiscal,0,3,2,0,5,0.0,#Div0,#Div0
third,0,1,0,0,1,0.0,#Div0,#Div0
Swedish,0,0,1,0,1,#Div0,#Div0,#Div0
resisting,0,0,0,2,2,#Div0,0.0,#Div0
Christian,0,3,0,0,3,0.0,#Div0,#Div0
different,0,5,3,0,8,0.0,#Div0,#Div0
Good,0,1,0,0,1,0.0,#Div0,#Div0
crucial,0,3,0,0,3,0.0,#Div0,#Div0
willful,0,0,1,0,1,#Div0,#Div0,#Div0
plummeted,0,0,0,2,2,#Div0,0.0,#Div0
impairs,0,0,0,1,1,#Div0,0.0,#Div0
regional,0,0,2,0,2,#Div0,#Div0,#Div0
citizens,0,0,1,0,1,#Div0,#Div0,#Div0
little,0,3,4,0,7,0.0,#Div0,#Div0
Sound,0,0,1,0,1,#Div0,#Div0,#Div0
Life,0,1,0,0,1,0.0,#Div0,#Div0
democratic,0,15,2,0,17,0.0,#Div0,#Div0
eleven,0,0,1,0,1,#Div0,#Div0,#Div0
intrinsic,0,1,0,0,1,0.0,#Div0,#Div0
Mexican,0,0,1,0,1,#Div0,#Div0,#Div0
right,0,2,0,0,2,0.0,#Div0,#Div0
brisk,0,1,0,0,1,0.0,#Div0,#Div0
jerked,0,0,1,0,1,#Div0,#Div0,#Div0
entrepreneurial,0,1,0,0,1,0.0,#Div0,#Div0
own,0,12,2,0,14,0.0,#Div0,#Div0
monetary,0,2,2,0,4,0.0,#Div0,#Div0
final,0,1,0,0,1,0.0,#Div0,#Div0
Run-control,0,0,1,0,1,#Div0,#Div0,#Div0
vinous,0,1,0,0,1,0.0,#Div0,#Div0
unconstrained,0,1,0,0,1,0.0,#Div0,#Div0
epidemic,0,0,1,0,1,#Div0,#Div0,#Div0
disgraced,0,1,0,0,1,0.0,#Div0,#Div0
religious,0,1,0,0,1,0.0,#Div0,#Div0
abject,0,2,0,0,2,0.0,#Div0,#Div0
caustic,0,0,1,0,1,#Div0,#Div0,#Div0
extreme,0,8,0,0,8,0.0,#Div0,#Div0
filthy,0,1,0,0,1,0.0,#Div0,#Div0
bottomless pit,0,0,0,1,1,#Div0,0.0,#Div0
huge,0,7,4,0,11,0.0,#Div0,#Div0
spiritual,0,2,0,0,2,0.0,#Div0,#Div0
lie,0,0,0,1,1,#Div0,0.0,#Div0
seamless,0,1,0,0,1,0.0,#Div0,#Div0
grain,0,1,0,0,1,0.0,#Div0,#Div0
compete,0,0,0,4,4,#Div0,0.0,#Div0
quiet,0,1,0,0,1,0.0,#Div0,#Div0
sound,0,0,2,0,2,#Div0,#Div0,#Div0
long-term,0,1,1,0,2,0.0,#Div0,#Div0
commercial,0,1,0,0,1,0.0,#Div0,#Div0
birth,0,0,0,2,2,#Div0,0.0,#Div0
Venezuelan,0,1,0,0,1,0.0,#Div0,#Div0
faith,0,1,0,0,1,0.0,#Div0,#Div0
deadly,0,1,2,0,3,0.0,#Div0,#Div0
mag,0,0,1,0,1,#Div0,#Div0,#Div0
protect,0,0,1,14,15,#Div0,0.0,#Div0
voter,0,0,1,0,1,#Div0,#Div0,#Div0
steals,0,0,0,6,6,#Div0,0.0,#Div0
coveted,0,1,0,0,1,0.0,#Div0,#Div0
oligarchic,0,2,0,0,2,0.0,#Div0,#Div0
civilized,0,1,0,0,1,0.0,#Div0,#Div0
disaster,0,0,0,2,2,#Div0,0.0,#Div0
violent,0,4,0,0,4,0.0,#Div0,#Div0
cultural-knitted,0,0,1,0,1,#Div0,#Div0,#Div0
Second,0,2,0,0,2,0.0,#Div0,#Div0
earned,0,2,0,0,2,0.0,#Div0,#Div0
wall,0,0,0,1,1,#Div0,0.0,#Div0
vested,0,0,1,0,1,#Div0,#Div0,#Div0
inflated,0,0,1,0,1,#Div0,#Div0,#Div0
necessary,0,4,0,0,4,0.0,#Div0,#Div0
marketed,0,0,0,1,1,#Div0,0.0,#Div0
taught,0,3,0,0,3,0.0,#Div0,#Div0
medical,0,1,1,0,2,0.0,#Div0,#Div0
rockets,0,0,0,3,3,#Div0,0.0,#Div0
corrupt,4,2,0,2,8,0.6666666666666666,0.6666666666666666,0.6666666666666666
challenged,0,0,0,5,5,#Div0,0.0,#Div0
stable,0,1,0,0,1,0.0,#Div0,#Div0
understandable,0,1,0,0,1,0.0,#Div0,#Div0
vocal,0,1,0,0,1,0.0,#Div0,#Div0
endanger,0,0,0,1,1,#Div0,0.0,#Div0
twentieth,0,0,1,0,1,#Div0,#Div0,#Div0
civil,0,3,9,0,12,0.0,#Div0,#Div0
steal,0,0,0,4,4,#Div0,0.0,#Div0
bohemian,0,1,0,0,1,0.0,#Div0,#Div0
official,0,0,1,0,1,#Div0,#Div0,#Div0
mantle,0,0,0,6,6,#Div0,0.0,#Div0
global,0,8,3,0,11,0.0,#Div0,#Div0
petty,0,1,0,0,1,0.0,#Div0,#Div0
anti-affirmative,0,1,0,0,1,0.0,#Div0,#Div0
investigational,0,1,0,0,1,0.0,#Div0,#Div0
informed,0,4,0,0,4,0.0,#Div0,#Div0
moderate-income,0,1,0,0,1,0.0,#Div0,#Div0
escalation,0,0,0,2,2,#Div0,0.0,#Div0
stupid,0,2,0,0,2,0.0,#Div0,#Div0
first-wave,0,0,2,0,2,#Div0,#Div0,#Div0
pregnant,0,1,0,0,1,0.0,#Div0,#Div0
reinforce,0,0,0,1,1,#Div0,0.0,#Div0
won,0,0,0,6,6,#Div0,0.0,#Div0
support,0,0,0,2,2,#Div0,0.0,#Div0
decreasing,0,0,1,1,2,#Div0,0.0,#Div0
ten-minute,0,1,0,0,1,0.0,#Div0,#Div0
expanded,0,1,0,0,1,0.0,#Div0,#Div0
sovereign,0,1,0,0,1,0.0,#Div0,#Div0
legitimate,0,2,0,0,2,0.0,#Div0,#Div0
anti-gun,0,5,6,0,11,0.0,#Div0,#Div0
chose,0,2,0,0,2,0.0,#Div0,#Div0
northern,0,2,0,0,2,0.0,#Div0,#Div0
pool,0,0,0,4,4,#Div0,0.0,#Div0
sole,0,0,1,0,1,#Div0,#Div0,#Div0
collective,0,0,1,0,1,#Div0,#Div0,#Div0
non-violent,0,2,0,0,2,0.0,#Div0,#Div0
important,0,9,0,0,9,0.0,#Div0,#Div0
unknown,0,1,0,0,1,0.0,#Div0,#Div0
defeated,1,0,0,1,2,1.0,0.5,0.6666666666666666
sells,0,0,0,3,3,#Div0,0.0,#Div0
noticeable,0,1,0,0,1,0.0,#Div0,#Div0
upward,0,0,1,0,1,#Div0,#Div0,#Div0
loses,0,0,0,1,1,#Div0,0.0,#Div0
interactive,0,1,0,0,1,0.0,#Div0,#Div0
maximum,0,1,1,0,2,0.0,#Div0,#Div0
do-good,0,1,0,0,1,0.0,#Div0,#Div0
natural,0,4,1,0,5,0.0,#Div0,#Div0
hypocritical,0,1,0,0,1,0.0,#Div0,#Div0
plant,0,0,0,2,2,#Div0,0.0,#Div0
trump,0,0,0,2,2,#Div0,0.0,#Div0
civic,0,1,0,0,1,0.0,#Div0,#Div0
horrible,0,3,0,0,3,0.0,#Div0,#Div0
unauthorized,0,1,0,0,1,0.0,#Div0,#Div0
attack,0,0,0,20,20,#Div0,0.0,#Div0
seventh,0,1,0,0,1,0.0,#Div0,#Div0
deny,0,1,0,0,1,0.0,#Div0,#Div0
advancement,0,0,0,7,7,#Div0,0.0,#Div0
team,0,0,0,3,3,#Div0,0.0,#Div0
ongoing,0,1,0,0,1,0.0,#Div0,#Div0
nourishing,0,2,0,0,2,0.0,#Div0,#Div0
fourteenth,0,0,1,0,1,#Div0,#Div0,#Div0
hinders,0,0,0,1,1,#Div0,0.0,#Div0
extremist,0,1,0,0,1,0.0,#Div0,#Div0
cultural,0,3,2,0,5,0.0,#Div0,#Div0
low-income,0,1,0,0,1,0.0,#Div0,#Div0
weakens,0,0,0,1,1,#Div0,0.0,#Div0
wealthy,0,3,0,0,3,0.0,#Div0,#Div0
middle,0,7,1,0,8,0.0,#Div0,#Div0
opponent,0,0,0,5,5,#Div0,0.0,#Div0
many,0,29,5,0,34,0.0,#Div0,#Div0
mountains,0,0,0,3,3,#Div0,0.0,#Div0
lawful,0,4,0,0,4,0.0,#Div0,#Div0
thunder,0,0,0,2,2,#Div0,0.0,#Div0
damages,0,0,0,3,3,#Div0,0.0,#Div0
stylish,0,1,0,0,1,0.0,#Div0,#Div0
anticipated,0,1,0,0,1,0.0,#Div0,#Div0
harm,0,0,0,2,2,#Div0,0.0,#Div0
debate,0,0,0,1,1,#Div0,0.0,#Div0
vast,0,6,0,0,6,0.0,#Div0,#Div0
fever,0,0,0,1,1,#Div0,0.0,#Div0
shrank,0,0,0,1,1,#Div0,0.0,#Div0
cubic,0,1,0,0,1,0.0,#Div0,#Div0
former,0,6,1,0,7,0.0,#Div0,#Div0
degree,0,0,1,0,1,#Div0,#Div0,#Div0
distinctive,0,1,0,0,1,0.0,#Div0,#Div0
unsustainable,0,1,0,0,1,0.0,#Div0,#Div0
roars,0,0,0,1,1,#Div0,0.0,#Div0
James-type,0,0,1,0,1,#Div0,#Div0,#Div0
active,0,2,0,0,2,0.0,#Div0,#Div0
expeditious,0,2,0,0,2,0.0,#Div0,#Div0
collar,0,0,1,0,1,#Div0,#Div0,#Div0
individual,0,9,5,0,14,0.0,#Div0,#Div0
elegant,0,2,0,0,2,0.0,#Div0,#Div0
tackling,0,0,0,2,2,#Div0,0.0,#Div0
western,0,2,1,0,3,0.0,#Div0,#Div0
Ethiopian,0,0,1,0,1,#Div0,#Div0,#Div0
abuse,0,0,0,4,4,#Div0,0.0,#Div0
altruistic,0,3,0,0,3,0.0,#Div0,#Div0
undue,0,1,0,0,1,0.0,#Div0,#Div0
destructive,1,0,0,1,2,1.0,0.5,0.6666666666666666
defender,0,0,0,1,1,#Div0,0.0,#Div0
produce,0,0,0,7,7,#Div0,0.0,#Div0
relieve,0,0,0,2,2,#Div0,0.0,#Div0
Only,0,1,0,0,1,0.0,#Div0,#Div0
considerable,0,0,2,0,2,#Div0,#Div0,#Div0
useless,0,1,0,0,1,0.0,#Div0,#Div0
adult,0,1,0,0,1,0.0,#Div0,#Div0
flow,0,0,0,9,9,#Div0,0.0,#Div0
historical,0,5,0,0,5,0.0,#Div0,#Div0
false,0,3,5,0,8,0.0,#Div0,#Div0
primary,0,6,0,0,6,0.0,#Div0,#Div0
manipulate,0,0,0,1,1,#Div0,0.0,#Div0
non-profit,0,3,0,0,3,0.0,#Div0,#Div0
firearms-related,0,1,0,0,1,0.0,#Div0,#Div0
cultivation,0,0,0,1,1,#Div0,0.0,#Div0
popular,0,7,0,0,7,0.0,#Div0,#Div0
disposable,0,0,2,0,2,#Div0,#Div0,#Div0
UK,0,0,2,0,2,#Div0,#Div0,#Div0
honest,0,4,0,0,4,0.0,#Div0,#Div0
Recognised,0,1,0,0,1,0.0,#Div0,#Div0
ethnic,0,0,2,0,2,#Div0,#Div0,#Div0
tastes,0,0,0,1,1,#Div0,0.0,#Div0
solid,0,1,0,0,1,0.0,#Div0,#Div0
degradation,0,0,0,1,1,#Div0,0.0,#Div0
hurts,0,0,0,1,1,#Div0,0.0,#Div0
first,0,8,7,0,15,0.0,#Div0,#Div0
unencumbered,0,1,0,0,1,0.0,#Div0,#Div0
federal,0,14,6,0,20,0.0,#Div0,#Div0
overthrow,0,0,0,1,1,#Div0,0.0,#Div0
myth,0,0,0,2,2,#Div0,0.0,#Div0
militant,0,2,0,0,2,0.0,#Div0,#Div0
surrender,0,0,0,3,3,#Div0,0.0,#Div0
domestic,0,1,4,0,5,0.0,#Div0,#Div0
broad-based,0,0,2,0,2,#Div0,#Div0,#Div0
dismal,0,2,0,0,2,0.0,#Div0,#Div0
miserable,0,1,0,0,1,0.0,#Div0,#Div0
immoral,0,1,0,0,1,0.0,#Div0,#Div0
recent,0,13,0,0,13,0.0,#Div0,#Div0
complex,0,1,0,0,1,0.0,#Div0,#Div0
war-torn,0,0,1,0,1,#Div0,#Div0,#Div0
lost,0,0,0,1,1,#Div0,0.0,#Div0
discrete,0,1,0,0,1,0.0,#Div0,#Div0
terrorized,0,0,0,1,1,#Div0,0.0,#Div0
pro-SSM,0,0,1,0,1,#Div0,#Div0,#Div0
conflict,0,0,0,1,1,#Div0,0.0,#Div0
strict,0,2,0,0,2,0.0,#Div0,#Div0
multi-artist,0,2,0,0,2,0.0,#Div0,#Div0
defending,0,0,0,4,4,#Div0,0.0,#Div0
uncontrollable,0,1,0,0,1,0.0,#Div0,#Div0
overall,0,2,1,0,3,0.0,#Div0,#Div0
overcome,1,0,0,0,1,1.0,1.0,1.0
abundant,0,1,0,0,1,0.0,#Div0,#Div0
anointed,0,0,1,0,1,#Div0,#Div0,#Div0
challenge,0,0,0,3,3,#Div0,0.0,#Div0
harbors,0,0,0,1,1,#Div0,0.0,#Div0
fallen,0,0,0,1,1,#Div0,0.0,#Div0
cripples,0,0,0,1,1,#Div0,0.0,#Div0
competes,0,0,0,2,2,#Div0,0.0,#Div0
stole,0,0,0,5,5,#Div0,0.0,#Div0
loose,0,0,1,0,1,#Div0,#Div0,#Div0
peaceful,0,4,0,0,4,0.0,#Div0,#Div0
child,0,0,1,0,1,#Div0,#Div0,#Div0
projected,0,1,0,0,1,0.0,#Div0,#Div0
libertarian,0,0,2,0,2,#Div0,#Div0,#Div0
liberal,0,5,0,0,5,0.0,#Div0,#Div0
other,0,49,9,0,58,0.0,#Div0,#Div0
fanatical,0,0,1,0,1,#Div0,#Div0,#Div0
Western,0,5,1,0,6,0.0,#Div0,#Div0
protecting,0,0,0,4,4,#Div0,0.0,#Div0
cures,0,0,0,3,3,#Div0,0.0,#Div0
distill,0,0,0,3,3,#Div0,0.0,#Div0
flat,0,0,1,0,1,#Div0,#Div0,#Div0
user-friendly,0,1,0,0,1,0.0,#Div0,#Div0
emergence,0,0,0,1,1,#Div0,0.0,#Div0
Low,0,0,1,0,1,#Div0,#Div0,#Div0
employed,0,0,0,1,1,#Div0,0.0,#Div0
guilty,0,1,0,0,1,0.0,#Div0,#Div0
mental,0,6,0,0,6,0.0,#Div0,#Div0
advance,0,0,0,5,5,#Div0,0.0,#Div0
aggressive,0,1,0,0,1,0.0,#Div0,#Div0
annual,0,4,0,0,4,0.0,#Div0,#Div0
failed,0,2,0,0,2,0.0,#Div0,#Div0
dramatic,0,4,0,0,4,0.0,#Div0,#Div0
expected,0,1,0,0,1,0.0,#Div0,#Div0
relieves,0,0,0,1,1,#Div0,0.0,#Div0
frontal,0,1,0,0,1,0.0,#Div0,#Div0
statist,0,2,0,0,2,0.0,#Div0,#Div0
partial,0,0,1,0,1,#Div0,#Div0,#Div0
front,0,4,0,0,4,0.0,#Div0,#Div0
Korean,0,1,0,0,1,0.0,#Div0,#Div0
industrial,0,0,2,0,2,#Div0,#Div0,#Div0
North-central,0,1,0,0,1,0.0,#Div0,#Div0
haven,0,0,0,2,2,#Div0,0.0,#Div0
firearms,0,0,1,0,1,#Div0,#Div0,#Div0
scientific,0,1,0,0,1,0.0,#Div0,#Div0
reckless,0,2,0,0,2,0.0,#Div0,#Div0
sacred,10,0,0,1,11,1.0,0.9090909090909091,0.9523809523809523
heterogeneous,0,0,2,0,2,#Div0,#Div0,#Div0
oppose,0,0,0,4,4,#Div0,0.0,#Div0
increases,0,0,0,1,1,#Div0,0.0,#Div0
anti-voter,0,0,1,0,1,#Div0,#Div0,#Div0
claws,0,0,0,1,1,#Div0,0.0,#Div0
bulwark,0,0,0,4,4,#Div0,0.0,#Div0
rotten,0,1,0,0,1,0.0,#Div0,#Div0
total,0,1,0,0,1,0.0,#Div0,#Div0
plenary,0,1,0,0,1,0.0,#Div0,#Div0
Net,0,0,1,0,1,#Div0,#Div0,#Div0
urgent,0,1,0,0,1,0.0,#Div0,#Div0
single,0,2,1,0,3,0.0,#Div0,#Div0
muslim,0,1,0,0,1,0.0,#Div0,#Div0
nationalized,0,1,0,0,1,0.0,#Div0,#Div0
senior,0,1,0,0,1,0.0,#Div0,#Div0
trajectory,0,0,0,1,1,#Div0,0.0,#Div0
Federal,0,1,0,0,1,0.0,#Div0,#Div0
Canadian,0,0,1,0,1,#Div0,#Div0,#Div0
secretive,0,0,1,0,1,#Div0,#Div0,#Div0
inferior,0,3,0,0,3,0.0,#Div0,#Div0
perpetrators,0,0,0,1,1,#Div0,0.0,#Div0
play,0,0,0,1,1,#Div0,0.0,#Div0
combating,0,0,0,2,2,#Div0,0.0,#Div0
negative,0,2,1,0,3,0.0,#Div0,#Div0
bludgeon,0,0,0,1,1,#Div0,0.0,#Div0
far-right,0,2,0,0,2,0.0,#Div0,#Div0
link,0,0,1,0,1,#Div0,#Div0,#Div0
imaginative,0,1,0,0,1,0.0,#Div0,#Div0
constitutional,0,5,0,0,5,0.0,#Div0,#Div0
mountain,0,0,0,8,8,#Div0,0.0,#Div0
hard-earned,0,1,0,0,1,0.0,#Div0,#Div0
regressive,0,2,0,0,2,0.0,#Div0,#Div0
cult,0,0,0,1,1,#Div0,0.0,#Div0
authoritarian,0,1,0,0,1,0.0,#Div0,#Div0
technological,0,1,1,0,2,0.0,#Div0,#Div0
efficient,0,1,1,0,2,0.0,#Div0,#Div0
brilliance,0,0,0,2,2,#Div0,0.0,#Div0
roar,0,0,0,1,1,#Div0,0.0,#Div0
local,0,12,5,0,17,0.0,#Div0,#Div0
revolution,0,0,0,2,2,#Div0,0.0,#Div0
dilute,0,0,0,3,3,#Div0,0.0,#Div0
ultraconservative,0,1,0,0,1,0.0,#Div0,#Div0
torch,0,0,0,2,2,#Div0,0.0,#Div0
decorative,0,0,1,0,1,#Div0,#Div0,#Div0
bully-by-prove,0,2,0,0,2,0.0,#Div0,#Div0
Many,0,4,0,0,4,0.0,#Div0,#Div0
veneration,0,0,0,2,2,#Div0,0.0,#Div0
Bad,0,1,0,0,1,0.0,#Div0,#Div0
great,0,18,0,0,18,0.0,#Div0,#Div0
cooling,0,0,0,2,2,#Div0,0.0,#Div0
featured,0,0,1,0,1,#Div0,#Div0,#Div0
relief,0,0,0,7,7,#Div0,0.0,#Div0
battling,0,0,0,1,1,#Div0,0.0,#Div0
lethal,0,1,0,0,1,0.0,#Div0,#Div0
political,0,32,3,0,35,0.0,#Div0,#Div0
crazy,0,2,0,0,2,0.0,#Div0,#Div0
machine-gun,0,0,1,0,1,#Div0,#Div0,#Div0
heightened,0,1,0,0,1,0.0,#Div0,#Div0
preserve,1,0,0,0,1,1.0,1.0,1.0
apex,0,0,0,4,4,#Div0,0.0,#Div0
card,0,0,0,1,1,#Div0,0.0,#Div0
sporadic,0,1,0,0,1,0.0,#Div0,#Div0
true,0,6,0,0,6,0.0,#Div0,#Div0
real,0,14,9,0,23,0.0,#Div0,#Div0
liberation,0,0,0,1,1,#Div0,0.0,#Div0
favorite,0,1,0,0,1,0.0,#Div0,#Div0
Wins,0,0,0,2,2,#Div0,0.0,#Div0
mutual,0,0,1,0,1,#Div0,#Div0,#Div0
ocean,0,0,0,2,2,#Div0,0.0,#Div0
pubic,0,1,3,0,4,0.0,#Div0,#Div0
Won,0,0,0,1,1,#Div0,0.0,#Div0
Environmental,0,1,0,0,1,0.0,#Div0,#Div0
idiocy,0,1,0,0,1,0.0,#Div0,#Div0
unconditional,0,1,0,0,1,0.0,#Div0,#Div0
high,0,7,1,0,8,0.0,#Div0,#Div0
daily,0,0,1,0,1,#Div0,#Div0,#Div0
vital,0,2,0,0,2,0.0,#Div0,#Div0
gives up,0,0,0,1,1,#Div0,0.0,#Div0
sinks,0,0,0,2,2,#Div0,0.0,#Div0
kills,0,0,0,4,4,#Div0,0.0,#Div0
secular,0,0,2,0,2,#Div0,#Div0,#Div0
reduces,0,0,0,1,1,#Div0,0.0,#Div0
steaming,0,1,0,0,1,0.0,#Div0,#Div0
appetite,0,0,0,1,1,#Div0,0.0,#Div0
Uniform,0,0,1,0,1,#Div0,#Div0,#Div0
happy,0,1,0,0,1,0.0,#Div0,#Div0
unelected,0,1,0,0,1,0.0,#Div0,#Div0
accidental,0,2,0,0,2,0.0,#Div0,#Div0
extra,0,2,1,0,3,0.0,#Div0,#Div0
attacked,0,0,0,2,2,#Div0,0.0,#Div0
hack,0,0,0,1,1,#Div0,0.0,#Div0
useful,0,2,0,0,2,0.0,#Div0,#Div0
chief,0,1,4,0,5,0.0,#Div0,#Div0
nanny,0,0,2,0,2,#Div0,#Div0,#Div0
legislative,0,4,0,0,4,0.0,#Div0,#Div0
Interpretive,0,1,0,0,1,0.0,#Div0,#Div0
Direct,0,0,1,0,1,#Div0,#Div0,#Div0
forced,0,1,0,0,1,0.0,#Div0,#Div0
alleviate,0,0,0,2,2,#Div0,0.0,#Div0
anonymous,0,3,0,0,3,0.0,#Div0,#Div0
journey,0,0,0,6,6,#Div0,0.0,#Div0
nut,0,0,2,0,2,#Div0,#Div0,#Div0
success,0,0,0,1,1,#Div0,0.0,#Div0
lesbian,0,1,0,0,1,0.0,#Div0,#Div0
Voluntary,0,0,2,0,2,#Div0,#Div0,#Div0
central,0,5,1,0,6,0.0,#Div0,#Div0
lax,0,1,0,0,1,0.0,#Div0,#Div0
complete,0,2,1,0,3,0.0,#Div0,#Div0
southern,0,1,0,0,1,0.0,#Div0,#Div0
tenant,0,0,1,0,1,#Div0,#Div0,#Div0
while,0,1,0,0,1,0.0,#Div0,#Div0
deepens,0,0,0,1,1,#Div0,0.0,#Div0
mobile,0,1,0,0,1,0.0,#Div0,#Div0
so-called,0,2,0,0,2,0.0,#Div0,#Div0
states.The,0,0,2,0,2,#Div0,#Div0,#Div0
Civil,0,1,0,0,1,0.0,#Div0,#Div0
knock-on,0,0,1,0,1,#Div0,#Div0,#Div0
noted,0,1,0,0,1,0.0,#Div0,#Div0
gun-free,0,1,0,0,1,0.0,#Div0,#Div0
successful,0,1,1,0,2,0.0,#Div0,#Div0
chapter,0,0,0,1,1,#Div0,0.0,#Div0
dying,0,0,0,2,2,#Div0,0.0,#Div0
estate-tax,0,0,1,0,1,#Div0,#Div0,#Div0
anti-democratic,0,1,0,0,1,0.0,#Div0,#Div0
hobble,0,0,1,0,1,#Div0,#Div0,#Div0
potent,0,1,0,0,1,0.0,#Div0,#Div0
exploitation,0,0,0,1,1,#Div0,0.0,#Div0
venous,0,1,0,0,1,0.0,#Div0,#Div0
opposing,0,0,0,8,8,#Div0,0.0,#Div0
selling,0,0,0,2,2,#Div0,0.0,#Div0
consensual,0,0,2,0,2,#Div0,#Div0,#Div0
first-round,0,0,1,0,1,#Div0,#Div0,#Div0
red,0,7,0,0,7,0.0,#Div0,#Div0
pressing,0,0,2,0,2,#Div0,#Div0,#Div0
cheap,0,1,0,0,1,0.0,#Div0,#Div0
tight,0,1,0,0,1,0.0,#Div0,#Div0
concentrated,0,1,0,0,1,0.0,#Div0,#Div0
domination,0,0,0,1,1,#Div0,0.0,#Div0
well-known,0,1,0,0,1,0.0,#Div0,#Div0
created,0,0,0,1,1,#Div0,0.0,#Div0
block,0,0,0,2,2,#Div0,0.0,#Div0
new,0,44,8,0,52,0.0,#Div0,#Div0
ceiling,0,0,0,1,1,#Div0,0.0,#Div0
e-mail,0,0,2,0,2,#Div0,#Div0,#Div0
military,0,1,7,0,8,0.0,#Div0,#Div0
corrupts,0,0,0,1,1,#Div0,0.0,#Div0
golden,0,0,2,0,2,#Div0,#Div0,#Div0
laissez-faire,0,0,1,0,1,#Div0,#Div0,#Div0
addicted,0,1,0,2,3,0.0,0.0,#Div0
sent,0,1,0,0,1,0.0,#Div0,#Div0
triumph,0,0,0,1,1,#Div0,0.0,#Div0
steady,0,3,0,0,3,0.0,#Div0,#Div0
exploits,0,0,0,2,2,#Div0,0.0,#Div0
stealing,0,0,0,3,3,#Div0,0.0,#Div0
innumerable,0,1,0,0,1,0.0,#Div0,#Div0
safeguard,0,0,0,1,1,#Div0,0.0,#Div0
pit,0,0,0,1,1,#Div0,0.0,#Div0
generates,0,0,0,6,6,#Div0,0.0,#Div0
freshman,0,2,0,0,2,0.0,#Div0,#Div0
intravenous,0,0,1,0,1,#Div0,#Div0,#Div0
current,0,10,1,0,11,0.0,#Div0,#Div0
irresponsible,0,1,0,0,1,0.0,#Div0,#Div0
everyday,0,2,0,0,2,0.0,#Div0,#Div0
external,0,1,0,0,1,0.0,#Div0,#Div0
interventionist,0,1,0,0,1,0.0,#Div0,#Div0
typical,0,3,0,0,3,0.0,#Div0,#Div0
critical,0,1,0,0,1,0.0,#Div0,#Div0
excess,0,1,0,0,1,0.0,#Div0,#Div0
Latin,0,2,0,0,2,0.0,#Div0,#Div0
conflicting,0,1,0,0,1,0.0,#Div0,#Div0
unprovoked,0,1,0,0,1,0.0,#Div0,#Div0
realms,0,0,0,1,1,#Div0,0.0,#Div0
restrains,0,0,0,1,1,#Div0,0.0,#Div0
Religious,0,0,1,0,1,#Div0,#Div0,#Div0
prey,0,0,0,1,1,#Div0,0.0,#Div0
announced,0,1,0,0,1,0.0,#Div0,#Div0
early,0,4,0,0,4,0.0,#Div0,#Div0
strengthens,0,0,0,3,3,#Div0,0.0,#Div0
balanced,0,0,1,0,1,#Div0,#Div0,#Div0
Each-based,0,1,0,0,1,0.0,#Div0,#Div0
polished,0,2,0,0,2,0.0,#Div0,#Div0
father,0,0,0,2,2,#Div0,0.0,#Div0
joint,0,1,1,0,2,0.0,#Div0,#Div0
combined,0,1,0,0,1,0.0,#Div0,#Div0
new-found,0,1,0,0,1,0.0,#Div0,#Div0
ethical,0,1,0,0,1,0.0,#Div0,#Div0
dont,0,1,0,0,1,0.0,#Div0,#Div0
utter,0,1,0,0,1,0.0,#Div0,#Div0
inhibiting,0,0,0,1,1,#Div0,0.0,#Div0
bottom,0,3,0,0,3,0.0,#Div0,#Div0
fearsome,0,1,0,0,1,0.0,#Div0,#Div0
bonfire,0,0,0,1,1,#Div0,0.0,#Div0
develop,0,0,0,2,2,#Div0,0.0,#Div0
flower,0,0,0,1,1,#Div0,0.0,#Div0
settled,0,0,1,0,1,#Div0,#Div0,#Div0
teen,0,0,1,0,1,#Div0,#Div0,#Div0
parasite,0,0,0,3,3,#Div0,0.0,#Div0
clear,0,1,1,0,2,0.0,#Div0,#Div0
Simple,0,2,0,0,2,0.0,#Div0,#Div0
detailed,0,1,0,0,1,0.0,#Div0,#Div0
mediocre,0,1,0,0,1,0.0,#Div0,#Div0
much,0,8,0,0,8,0.0,#Div0,#Div0
eternal,0,2,0,0,2,0.0,#Div0,#Div0
limitless,0,1,0,0,1,0.0,#Div0,#Div0
faceless,0,1,0,0,1,0.0,#Div0,#Div0
progression,0,0,0,2,2,#Div0,0.0,#Div0
left-wing,0,1,0,0,1,0.0,#Div0,#Div0
congressional,0,1,0,0,1,0.0,#Div0,#Div0
anti-tax,0,0,1,0,1,#Div0,#Div0,#Div0
unfortunate,0,1,0,0,1,0.0,#Div0,#Div0
Excellent,0,1,0,0,1,0.0,#Div0,#Div0
obscure,0,1,0,0,1,0.0,#Div0,#Div0
open,0,2,0,0,2,0.0,#Div0,#Div0
ideal,0,1,0,0,1,0.0,#Div0,#Div0
diminish,0,0,0,1,1,#Div0,0.0,#Div0
drunken,0,1,0,0,1,0.0,#Div0,#Div0
obstructive,1,1,0,0,2,0.5,1.0,0.6666666666666666
»,0,1,0,0,1,0.0,#Div0,#Div0
handgun,0,0,1,0,1,#Div0,#Div0,#Div0
tribal,0,1,2,0,3,0.0,#Div0,#Div0
developed,0,2,0,0,2,0.0,#Div0,#Div0
dead,0,0,1,0,1,#Div0,#Div0,#Div0
multi-member,0,1,0,0,1,0.0,#Div0,#Div0
kill,0,0,0,6,6,#Div0,0.0,#Div0
common-sense,0,1,0,0,1,0.0,#Div0,#Div0
fire,0,0,0,1,1,#Div0,0.0,#Div0
interior,0,0,1,0,1,#Div0,#Div0,#Div0
unsung,0,0,0,1,1,#Div0,0.0,#Div0
exclusive,0,1,0,0,1,0.0,#Div0,#Div0
gun,0,0,71,0,71,#Div0,#Div0,#Div0
mean,0,3,0,0,3,0.0,#Div0,#Div0
young,0,5,1,2,8,0.0,0.0,#Div0
threatens,0,0,0,2,2,#Div0,0.0,#Div0
unnecessary,0,1,0,0,1,0.0,#Div0,#Div0
competitive,0,2,3,0,5,0.0,#Div0,#Div0
lasting,0,1,1,0,2,0.0,#Div0,#Div0
wave,0,0,0,1,1,#Div0,0.0,#Div0
stolen,0,0,0,4,4,#Div0,0.0,#Div0
future,0,5,0,0,5,0.0,#Div0,#Div0
neocon,0,0,1,0,1,#Div0,#Div0,#Div0
unwarranted,0,1,0,0,1,0.0,#Div0,#Div0
building,0,0,0,1,1,#Div0,0.0,#Div0
gun-later,0,1,0,0,1,0.0,#Div0,#Div0
material,0,0,2,0,2,#Div0,#Div0,#Div0
laboratory,0,0,0,5,5,#Div0,0.0,#Div0
tangible,0,1,0,0,1,0.0,#Div0,#Div0
enslaves,0,0,0,4,4,#Div0,0.0,#Div0
evaporates,0,0,0,1,1,#Div0,0.0,#Div0
lassies-faire,0,0,1,0,1,#Div0,#Div0,#Div0
rampant,0,0,1,0,1,#Div0,#Div0,#Div0
shooting,0,0,1,0,1,#Div0,#Div0,#Div0
eradicate,0,0,0,4,4,#Div0,0.0,#Div0
buying,0,0,0,3,3,#Div0,0.0,#Div0
concealed,0,0,1,0,1,#Div0,#Div0,#Div0
parental,0,2,0,0,2,0.0,#Div0,#Div0
cornerstone,0,0,0,1,1,#Div0,0.0,#Div0
conflicts,0,0,0,1,1,#Div0,0.0,#Div0
yearlong,0,0,1,0,1,#Div0,#Div0,#Div0
butchered,0,0,0,1,1,#Div0,0.0,#Div0
NOT,0,1,0,0,1,0.0,#Div0,#Div0
protects,0,0,0,4,4,#Div0,0.0,#Div0
high-yield,0,2,0,0,2,0.0,#Div0,#Div0
Jewish,0,0,1,0,1,#Div0,#Div0,#Div0
remarkable,0,1,0,0,1,0.0,#Div0,#Div0
combat,0,0,0,2,2,#Div0,0.0,#Div0
collateral,0,2,0,0,2,0.0,#Div0,#Div0
freaky,0,2,0,0,2,0.0,#Div0,#Div0
white,0,2,2,0,4,0.0,#Div0,#Div0
tremendous,0,0,3,0,3,#Div0,#Div0,#Div0
utterly,0,1,0,0,1,0.0,#Div0,#Div0
abyss,0,0,0,8,8,#Div0,0.0,#Div0
massive,0,1,2,0,3,0.0,#Div0,#Div0
logical,0,1,0,0,1,0.0,#Div0,#Div0
rough,0,1,0,0,1,0.0,#Div0,#Div0
Minimum,0,1,0,0,1,0.0,#Div0,#Div0
promote,0,1,0,0,1,0.0,#Div0,#Div0
main,0,2,0,0,2,0.0,#Div0,#Div0
war,0,0,0,4,4,#Div0,0.0,#Div0
notorious,0,1,0,0,1,0.0,#Div0,#Div0
engine,0,0,0,1,1,#Div0,0.0,#Div0
recall,0,0,2,0,2,#Div0,#Div0,#Div0
bullish,0,0,2,0,2,#Div0,#Div0,#Div0
satanic,0,1,0,0,1,0.0,#Div0,#Div0
bold-faced,0,1,0,0,1,0.0,#Div0,#Div0
large,0,5,0,0,5,0.0,#Div0,#Div0
bad,0,4,1,0,5,0.0,#Div0,#Div0
such,0,9,0,0,9,0.0,#Div0,#Div0
net,0,0,2,0,2,#Div0,#Div0,#Div0
opposed,0,0,0,3,3,#Div0,0.0,#Div0
entire,0,7,0,0,7,0.0,#Div0,#Div0
rich,0,5,1,0,6,0.0,#Div0,#Div0
beacon,0,0,0,2,2,#Div0,0.0,#Div0
only,0,8,0,0,8,0.0,#Div0,#Div0
automatic,0,1,0,0,1,0.0,#Div0,#Div0
guard,0,0,0,1,1,#Div0,0.0,#Div0
one-vote,0,0,2,0,2,#Div0,#Div0,#Div0
convenient,0,1,0,0,1,0.0,#Div0,#Div0
claws of,0,0,0,1,1,#Div0,0.0,#Div0
moderate,0,2,0,0,2,0.0,#Div0,#Div0
six-shot,0,3,0,0,3,0.0,#Div0,#Div0
lubricate,0,0,0,2,2,#Div0,0.0,#Div0
plain,0,1,0,0,1,0.0,#Div0,#Div0
brutal,0,1,0,0,1,0.0,#Div0,#Div0
regulatory,0,1,1,0,2,0.0,#Div0,#Div0
arbitrary,0,1,0,0,1,0.0,#Div0,#Div0
loss,0,0,0,4,4,#Div0,0.0,#Div0
poor,0,5,0,0,5,0.0,#Div0,#Div0
Logical,0,0,5,0,5,#Div0,#Div0,#Div0
proper,0,1,1,0,2,0.0,#Div0,#Div0
renal,0,1,0,0,1,0.0,#Div0,#Div0
hurt,0,0,0,5,5,#Div0,0.0,#Div0
quick,0,2,0,0,2,0.0,#Div0,#Div0
collateral damage,0,0,0,2,2,#Div0,0.0,#Div0
British,0,0,5,0,5,#Div0,#Div0,#Div0
Consumer-Driven,0,2,0,0,2,0.0,#Div0,#Div0
win,1,0,0,8,9,1.0,0.1111111111111111,0.19999999999999998
responsible,0,1,0,0,1,0.0,#Div0,#Div0
Besieges,0,0,0,1,1,#Div0,0.0,#Div0
communal,0,0,1,0,1,#Div0,#Div0,#Div0
pond,0,0,0,2,2,#Div0,0.0,#Div0
US,0,0,3,0,3,#Div0,#Div0,#Div0
collectible,0,1,0,0,1,0.0,#Div0,#Div0
Kill,0,0,0,1,1,#Div0,0.0,#Div0
free-market-loving,0,0,1,0,1,#Div0,#Div0,#Div0
conjoined,0,0,1,0,1,#Div0,#Div0,#Div0
potential,0,2,0,0,2,0.0,#Div0,#Div0
prevents,0,0,0,1,1,#Div0,0.0,#Div0
standard,0,1,0,0,1,0.0,#Div0,#Div0
terrible,0,1,0,0,1,0.0,#Div0,#Div0
ultimate,0,6,0,0,6,0.0,#Div0,#Div0
key,0,2,1,0,3,0.0,#Div0,#Div0
shrink,0,0,0,1,1,#Div0,0.0,#Div0
mayoral,0,0,2,0,2,#Div0,#Div0,#Div0
financial,0,6,2,0,8,0.0,#Div0,#Div0
funny,0,1,0,0,1,0.0,#Div0,#Div0
Most-modern,0,1,0,0,1,0.0,#Div0,#Div0
preserves,0,0,0,1,1,#Div0,0.0,#Div0
non-extent,0,0,1,0,1,#Div0,#Div0,#Div0
wins,0,0,0,2,2,#Div0,0.0,#Div0
safe,0,3,0,0,3,0.0,#Div0,#Div0
short,0,3,0,0,3,0.0,#Div0,#Div0
overdose,0,0,0,1,1,#Div0,0.0,#Div0
unwavering,0,1,0,0,1,0.0,#Div0,#Div0
black,0,0,5,0,5,#Div0,#Div0,#Div0
fourth,0,0,1,0,1,#Div0,#Div0,#Div0
psychological,0,3,0,0,3,0.0,#Div0,#Div0
technical,0,2,0,0,2,0.0,#Div0,#Div0
destroying,0,0,0,4,4,#Div0,0.0,#Div0
pimp,0,0,0,2,2,#Div0,0.0,#Div0
condemn,0,0,1,0,1,#Div0,#Div0,#Div0
Multicultural,0,1,0,0,1,0.0,#Div0,#Div0
proven,0,2,0,0,2,0.0,#Div0,#Div0
encumbers,0,0,0,1,1,#Div0,0.0,#Div0
anti-blockade,0,0,1,0,1,#Div0,#Div0,#Div0
solar,0,0,1,0,1,#Div0,#Div0,#Div0
societal,0,1,0,0,1,0.0,#Div0,#Div0
selfish,0,0,1,0,1,#Div0,#Div0,#Div0
loud,0,0,1,0,1,#Div0,#Div0,#Div0
copyright,0,0,2,0,2,#Div0,#Div0,#Div0
hereditary,0,1,0,0,1,0.0,#Div0,#Div0
innocent,0,7,0,0,7,0.0,#Div0,#Div0
elite,0,1,0,0,1,0.0,#Div0,#Div0
generate,0,0,0,5,5,#Div0,0.0,#Div0
mask,0,0,0,2,2,#Div0,0.0,#Div0
futile,0,1,0,0,1,0.0,#Div0,#Div0
casualties,0,0,0,1,1,#Div0,0.0,#Div0
baseball,0,0,0,1,1,#Div0,0.0,#Div0
rural,0,3,0,0,3,0.0,#Div0,#Div0
sad,0,3,0,0,3,0.0,#Div0,#Div0
killing,0,0,0,5,5,#Div0,0.0,#Div0
Sure,0,2,0,0,2,0.0,#Div0,#Div0
carry,0,0,1,0,1,#Div0,#Div0,#Div0
old,0,2,4,0,6,0.0,#Div0,#Div0
dynamic,0,2,0,0,2,0.0,#Div0,#Div0
Socialist,0,2,0,0,2,0.0,#Div0,#Div0
draconian,0,1,0,0,1,0.0,#Div0,#Div0
American,0,14,15,0,29,0.0,#Div0,#Div0
well-run,0,1,0,0,1,0.0,#Div0,#Div0
money-maddened,0,1,0,0,1,0.0,#Div0,#Div0
conceivable,0,1,0,0,1,0.0,#Div0,#Div0
impede,0,0,1,0,1,#Div0,#Div0,#Div0
utopian,0,1,0,0,1,0.0,#Div0,#Div0
immediate,0,1,0,0,1,0.0,#Div0,#Div0
impact,0,0,0,2,2,#Div0,0.0,#Div0
destruction,0,0,0,4,4,#Div0,0.0,#Div0
idolize,0,0,0,2,2,#Div0,0.0,#Div0
advances,0,0,0,4,4,#Div0,0.0,#Div0
subsequent,0,2,0,0,2,0.0,#Div0,#Div0
dark clouds,0,0,0,2,2,#Div0,0.0,#Div0
selective,0,1,0,0,1,0.0,#Div0,#Div0
inefficient,0,1,0,0,1,0.0,#Div0,#Div0
Big,0,2,1,0,3,0.0,#Div0,#Div0
learned,0,0,3,0,3,#Div0,#Div0,#Div0
Palestinian,0,2,1,0,3,0.0,#Div0,#Div0
prime,0,1,0,0,1,0.0,#Div0,#Div0
interstate,0,0,1,0,1,#Div0,#Div0,#Div0
conservative,0,5,0,0,5,0.0,#Div0,#Div0
scare,0,0,2,0,2,#Div0,#Div0,#Div0
governmental,0,1,0,0,1,0.0,#Div0,#Div0
electronic,0,1,1,0,2,0.0,#Div0,#Div0
pill,0,0,0,3,3,#Div0,0.0,#Div0
suggest,0,1,0,0,1,0.0,#Div0,#Div0
demolished,0,0,0,1,1,#Div0,0.0,#Div0
defended,0,0,0,6,6,#Div0,0.0,#Div0
enforce,0,0,0,1,1,#Div0,0.0,#Div0
special,0,3,1,0,4,0.0,#Div0,#Div0
wide-ranging,0,0,2,0,2,#Div0,#Div0,#Div0
god,0,0,0,2,2,#Div0,0.0,#Div0
