token,tp_cases,fp_cases,tn_cases,fn_cases,total_cases,precision,recall,f1-score
,0,3,390,0,393,0.0,#Div0,#Div0
ladder,0,0,0,3,3,#Div0,0.0,#Div0
Reaching,0,0,0,1,1,#Div0,0.0,#Div0
today,0,0,3,0,3,#Div0,#Div0,#Div0
shoud,0,0,1,0,1,#Div0,#Div0,#Div0
quits,0,0,1,0,1,#Div0,#Div0,#Div0
base,0,0,0,2,2,#Div0,0.0,#Div0
Smith,0,0,1,0,1,#Div0,#Div0,#Div0
multiply,0,0,1,1,2,#Div0,0.0,#Div0
contrasted,0,0,1,0,1,#Div0,#Div0,#Div0
laud,0,0,1,0,1,#Div0,#Div0,#Div0
suppose,0,0,2,0,2,#Div0,#Div0,#Div0
close,0,0,0,1,1,#Div0,0.0,#Div0
decreases,0,0,1,0,1,#Div0,#Div0,#Div0
Shafeek,0,0,1,0,1,#Div0,#Div0,#Div0
Given,0,0,1,0,1,#Div0,#Div0,#Div0
unique,0,0,1,0,1,#Div0,#Div0,#Div0
category,0,0,2,0,2,#Div0,#Div0,#Div0
write,0,0,5,0,5,#Div0,#Div0,#Div0
guarantee,0,0,2,0,2,#Div0,#Div0,#Div0
recover,0,0,1,0,1,#Div0,#Div0,#Div0
developed,0,0,5,3,8,#Div0,0.0,#Div0
inorder,0,0,1,0,1,#Div0,#Div0,#Div0
substitute,0,0,1,0,1,#Div0,#Div0,#Div0
identified,0,0,2,0,2,#Div0,#Div0,#Div0
studio,0,0,1,0,1,#Div0,#Div0,#Div0
emerge,0,0,0,1,1,#Div0,0.0,#Div0
suit,0,0,1,1,2,#Div0,0.0,#Div0
confirm,0,0,1,0,1,#Div0,#Div0,#Div0
real,0,0,27,0,27,#Div0,#Div0,#Div0
define,0,0,3,0,3,#Div0,#Div0,#Div0
tons,0,0,0,1,1,#Div0,0.0,#Div0
concentrates,0,0,0,1,1,#Div0,0.0,#Div0
instant,0,0,1,0,1,#Div0,#Div0,#Div0
indepth,0,0,0,1,1,#Div0,0.0,#Div0
ll,0,0,5,0,5,#Div0,#Div0,#Div0
size,0,0,1,0,1,#Div0,#Div0,#Div0
waiting,0,0,4,0,4,#Div0,#Div0,#Div0
following,0,0,7,1,8,#Div0,0.0,#Div0
Rohn,0,0,1,0,1,#Div0,#Div0,#Div0
accepted,0,0,2,0,2,#Div0,#Div0,#Div0
chance,0,0,1,0,1,#Div0,#Div0,#Div0
don,0,0,3,0,3,#Div0,#Div0,#Div0
completed,0,0,1,0,1,#Div0,#Div0,#Div0
remember,0,0,15,0,15,#Div0,#Div0,#Div0
loans,0,0,1,0,1,#Div0,#Div0,#Div0
selected,0,0,1,0,1,#Div0,#Div0,#Div0
pursue,0,0,0,2,2,#Div0,0.0,#Div0
usefull,0,0,2,0,2,#Div0,#Div0,#Div0
game,0,0,2,0,2,#Div0,#Div0,#Div0
talk,0,10,8,0,18,0.0,#Div0,#Div0
plans,0,0,1,0,1,#Div0,#Div0,#Div0
disappear,0,0,2,1,3,#Div0,0.0,#Div0
shelter,0,0,1,0,1,#Div0,#Div0,#Div0
enter,0,1,2,0,3,0.0,#Div0,#Div0
half,0,0,1,0,1,#Div0,#Div0,#Div0
rare,0,0,0,1,1,#Div0,0.0,#Div0
undertaken,0,0,1,0,1,#Div0,#Div0,#Div0
design,0,0,5,0,5,#Div0,#Div0,#Div0
access,0,0,1,0,1,#Div0,#Div0,#Div0
horror,0,0,1,0,1,#Div0,#Div0,#Div0
bonds,0,0,0,2,2,#Div0,0.0,#Div0
smooth,0,0,0,1,1,#Div0,0.0,#Div0
lots,0,0,22,0,22,#Div0,#Div0,#Div0
unfamiliar,0,0,1,0,1,#Div0,#Div0,#Div0
asserted,0,0,1,0,1,#Div0,#Div0,#Div0
run,1,0,1,6,8,1.0,0.14285714285714285,0.25
attractivity,0,0,0,1,1,#Div0,0.0,#Div0
expanded,0,0,0,2,2,#Div0,0.0,#Div0
facing,0,0,0,2,2,#Div0,0.0,#Div0
effect,0,0,1,0,1,#Div0,#Div0,#Div0
listen,0,1,1,0,2,0.0,#Div0,#Div0
means,0,0,26,1,27,#Div0,0.0,#Div0
sticks,0,0,3,0,3,#Div0,#Div0,#Div0
license,0,0,1,0,1,#Div0,#Div0,#Div0
buys,0,0,1,0,1,#Div0,#Div0,#Div0
Italian,0,0,2,0,2,#Div0,#Div0,#Div0
jungle,0,0,0,2,2,#Div0,0.0,#Div0
reading,0,0,5,0,5,#Div0,#Div0,#Div0
love,0,0,10,0,10,#Div0,#Div0,#Div0
collect,0,0,1,0,1,#Div0,#Div0,#Div0
Spikes,0,0,0,1,1,#Div0,0.0,#Div0
law,0,0,1,1,2,#Div0,0.0,#Div0
balanced,0,0,0,1,1,#Div0,0.0,#Div0
educating,0,0,2,0,2,#Div0,#Div0,#Div0
Agreeing,0,0,1,0,1,#Div0,#Div0,#Div0
buy,0,0,34,1,35,#Div0,0.0,#Div0
happen,0,0,7,0,7,#Div0,#Div0,#Div0
sopping,0,0,1,0,1,#Div0,#Div0,#Div0
inspired,0,0,1,0,1,#Div0,#Div0,#Div0
wealthy,0,0,1,0,1,#Div0,#Div0,#Div0
yong,0,0,3,0,3,#Div0,#Div0,#Div0
foregin,0,0,3,0,3,#Div0,#Div0,#Div0
stay,0,0,8,1,9,#Div0,0.0,#Div0
attachment,0,0,0,1,1,#Div0,0.0,#Div0
ecology,0,0,1,0,1,#Div0,#Div0,#Div0
suffer,1,0,0,0,1,1.0,1.0,1.0
differents,0,0,1,0,1,#Div0,#Div0,#Div0
morgage,0,0,1,0,1,#Div0,#Div0,#Div0
reed,0,0,1,0,1,#Div0,#Div0,#Div0
accorded,0,0,1,0,1,#Div0,#Div0,#Div0
intended,0,0,1,0,1,#Div0,#Div0,#Div0
hidden,0,0,0,2,2,#Div0,0.0,#Div0
destroyed,0,0,1,0,1,#Div0,#Div0,#Div0
numerous,0,1,1,0,2,0.0,#Div0,#Div0
ecological,0,0,3,0,3,#Div0,#Div0,#Div0
powerful,0,0,0,1,1,#Div0,0.0,#Div0
technological,0,0,4,0,4,#Div0,#Div0,#Div0
groups,0,0,1,0,1,#Div0,#Div0,#Div0
measure,0,0,0,2,2,#Div0,0.0,#Div0
hackers,0,0,1,0,1,#Div0,#Div0,#Div0
helped,0,0,2,0,2,#Div0,#Div0,#Div0
overwhelm,0,0,0,1,1,#Div0,0.0,#Div0
answer,0,0,3,0,3,#Div0,#Div0,#Div0
share,0,0,0,1,1,#Div0,0.0,#Div0
periods,0,0,1,0,1,#Div0,#Div0,#Div0
ware,0,0,2,0,2,#Div0,#Div0,#Div0
Nowadays,0,0,1,0,1,#Div0,#Div0,#Div0
adays,0,0,3,0,3,#Div0,#Div0,#Div0
wander,0,0,1,0,1,#Div0,#Div0,#Div0
needed,0,0,13,0,13,#Div0,#Div0,#Div0
financial,0,0,7,0,7,#Div0,#Div0,#Div0
list,0,0,1,0,1,#Div0,#Div0,#Div0
discussing,0,0,1,0,1,#Div0,#Div0,#Div0
composed,0,0,1,0,1,#Div0,#Div0,#Div0
pizza,0,0,1,0,1,#Div0,#Div0,#Div0
walk,0,0,4,0,4,#Div0,#Div0,#Div0
change,0,0,28,0,28,#Div0,#Div0,#Div0
sleeping,0,0,3,0,3,#Div0,#Div0,#Div0
eighteen,0,0,1,0,1,#Div0,#Div0,#Div0
particular,0,0,16,0,16,#Div0,#Div0,#Div0
wondering,0,0,1,0,1,#Div0,#Div0,#Div0
neutral,0,0,0,2,2,#Div0,0.0,#Div0
specializing,0,0,7,0,7,#Div0,#Div0,#Div0
issues,0,0,1,0,1,#Div0,#Div0,#Div0
sufficient,0,0,4,0,4,#Div0,#Div0,#Div0
follwing,0,0,1,0,1,#Div0,#Div0,#Div0
christmas,0,0,1,0,1,#Div0,#Div0,#Div0
City,0,0,1,0,1,#Div0,#Div0,#Div0
self,0,0,5,0,5,#Div0,#Div0,#Div0
hang,0,0,0,1,1,#Div0,0.0,#Div0
nan,0,0,0,118,118,#Div0,0.0,#Div0
presents,0,0,2,0,2,#Div0,#Div0,#Div0
somthing,0,0,1,0,1,#Div0,#Div0,#Div0
cant,0,0,1,0,1,#Div0,#Div0,#Div0
maker,0,0,2,0,2,#Div0,#Div0,#Div0
tours,0,0,1,0,1,#Div0,#Div0,#Div0
reminding,0,0,1,0,1,#Div0,#Div0,#Div0
fresh,0,0,1,3,4,#Div0,0.0,#Div0
realm,0,0,1,0,1,#Div0,#Div0,#Div0
brand,0,0,1,0,1,#Div0,#Div0,#Div0
Depending,0,0,2,0,2,#Div0,#Div0,#Div0
chances,0,0,1,0,1,#Div0,#Div0,#Div0
chose,0,0,2,0,2,#Div0,#Div0,#Div0
brought,0,0,0,2,2,#Div0,0.0,#Div0
poins,0,0,1,0,1,#Div0,#Div0,#Div0
teacher,0,0,2,0,2,#Div0,#Div0,#Div0
difficult,0,0,4,1,5,#Div0,0.0,#Div0
economical,0,0,3,0,3,#Div0,#Div0,#Div0
manage,0,0,0,3,3,#Div0,0.0,#Div0
enlarge,0,0,0,2,2,#Div0,0.0,#Div0
habits,0,0,1,0,1,#Div0,#Div0,#Div0
taste,0,0,0,1,1,#Div0,0.0,#Div0
participate,0,0,3,0,3,#Div0,#Div0,#Div0
add,0,0,1,3,4,#Div0,0.0,#Div0
isolation,0,0,2,0,2,#Div0,#Div0,#Div0
famous,0,0,10,0,10,#Div0,#Div0,#Div0
inhabitants,0,0,2,0,2,#Div0,#Div0,#Div0
accurate,0,0,1,0,1,#Div0,#Div0,#Div0
hectic,0,0,0,2,2,#Div0,0.0,#Div0
contributes,0,0,0,1,1,#Div0,0.0,#Div0
succesful,0,0,2,0,2,#Div0,#Div0,#Div0
pressures,0,0,0,1,1,#Div0,0.0,#Div0
opted,0,0,1,0,1,#Div0,#Div0,#Div0
ask,0,0,10,0,10,#Div0,#Div0,#Div0
reminded,0,0,1,0,1,#Div0,#Div0,#Div0
atheistic,0,0,1,0,1,#Div0,#Div0,#Div0
creat,0,0,3,0,3,#Div0,#Div0,#Div0
conciliating,0,0,0,1,1,#Div0,0.0,#Div0
common,0,0,4,1,5,#Div0,0.0,#Div0
friends,0,0,2,0,2,#Div0,#Div0,#Div0
expressing,0,0,1,1,2,#Div0,0.0,#Div0
actor,0,0,0,1,1,#Div0,0.0,#Div0
contained,0,0,0,2,2,#Div0,0.0,#Div0
Organization,0,0,1,0,1,#Div0,#Div0,#Div0
lies,0,0,1,0,1,#Div0,#Div0,#Div0
relax,0,0,1,1,2,#Div0,0.0,#Div0
ex,0,0,1,0,1,#Div0,#Div0,#Div0
electrical,0,0,1,0,1,#Div0,#Div0,#Div0
fulfill,0,0,0,1,1,#Div0,0.0,#Div0
focuses,0,0,0,3,3,#Div0,0.0,#Div0
freak,0,0,1,0,1,#Div0,#Div0,#Div0
industry,0,1,3,0,4,0.0,#Div0,#Div0
recognized,0,0,1,0,1,#Div0,#Div0,#Div0
total,0,0,3,0,3,#Div0,#Div0,#Div0
generations,0,2,0,0,2,0.0,#Div0,#Div0
certain,0,0,19,0,19,#Div0,#Div0,#Div0
plenty,0,0,1,0,1,#Div0,#Div0,#Div0
fig-plastic,0,0,1,0,1,#Div0,#Div0,#Div0
symbol,0,0,0,2,2,#Div0,0.0,#Div0
resist,0,0,0,1,1,#Div0,0.0,#Div0
same,0,0,51,1,52,#Div0,0.0,#Div0
ordered,0,0,3,0,3,#Div0,#Div0,#Div0
become,0,0,31,2,33,#Div0,0.0,#Div0
modern,0,0,7,0,7,#Div0,#Div0,#Div0
verify,0,0,1,0,1,#Div0,#Div0,#Div0
Hut,0,0,1,0,1,#Div0,#Div0,#Div0
succesfull,0,0,2,0,2,#Div0,#Div0,#Div0
earn,0,0,3,0,3,#Div0,#Div0,#Div0
grate,0,0,1,0,1,#Div0,#Div0,#Div0
there,0,0,1,0,1,#Div0,#Div0,#Div0
philosopher,0,0,1,0,1,#Div0,#Div0,#Div0
unsatisfied,0,0,1,0,1,#Div0,#Div0,#Div0
producing,0,0,1,0,1,#Div0,#Div0,#Div0
acquire,0,0,1,1,2,#Div0,0.0,#Div0
link,0,0,1,0,1,#Div0,#Div0,#Div0
spraying,0,0,2,0,2,#Div0,#Div0,#Div0
prohibiting,0,0,1,0,1,#Div0,#Div0,#Div0
traveling,0,23,38,0,61,0.0,#Div0,#Div0
ve,0,0,6,0,6,#Div0,#Div0,#Div0
determines,0,0,1,0,1,#Div0,#Div0,#Div0
spilled,0,0,1,0,1,#Div0,#Div0,#Div0
sitting,0,0,1,0,1,#Div0,#Div0,#Div0
trying,0,0,32,0,32,#Div0,#Div0,#Div0
surface,0,1,0,0,1,0.0,#Div0,#Div0
gains,0,0,1,0,1,#Div0,#Div0,#Div0
bought,0,0,7,0,7,#Div0,#Div0,#Div0
categorizing,0,0,1,0,1,#Div0,#Div0,#Div0
kinds,0,0,8,0,8,#Div0,#Div0,#Div0
taken,0,0,2,0,2,#Div0,#Div0,#Div0
out,0,0,1,5,6,#Div0,0.0,#Div0
assistant,0,0,1,0,1,#Div0,#Div0,#Div0
Is,0,0,4,0,4,#Div0,#Div0,#Div0
watching,0,0,8,0,8,#Div0,#Div0,#Div0
key,0,0,0,3,3,#Div0,0.0,#Div0
profit,0,0,1,0,1,#Div0,#Div0,#Div0
catholic,0,0,2,0,2,#Div0,#Div0,#Div0
experienced,0,0,5,0,5,#Div0,#Div0,#Div0
pack,0,0,1,0,1,#Div0,#Div0,#Div0
neede,0,0,1,0,1,#Div0,#Div0,#Div0
zones,0,0,1,0,1,#Div0,#Div0,#Div0
accomodate,0,0,1,0,1,#Div0,#Div0,#Div0
marine,0,0,1,0,1,#Div0,#Div0,#Div0
expert,0,0,3,0,3,#Div0,#Div0,#Div0
NHS,0,0,1,0,1,#Div0,#Div0,#Div0
invent,0,0,1,0,1,#Div0,#Div0,#Div0
worse,0,0,1,0,1,#Div0,#Div0,#Div0
serious,0,0,2,0,2,#Div0,#Div0,#Div0
pioneered,0,0,1,0,1,#Div0,#Div0,#Div0
school-time,0,0,1,0,1,#Div0,#Div0,#Div0
subject,0,0,19,0,19,#Div0,#Div0,#Div0
matter,0,0,11,0,11,#Div0,#Div0,#Div0
recommend,0,0,1,0,1,#Div0,#Div0,#Div0
twenty,0,0,8,0,8,#Div0,#Div0,#Div0
railways,0,0,1,0,1,#Div0,#Div0,#Div0
scientists,0,0,1,0,1,#Div0,#Div0,#Div0
Traveling,0,0,6,0,6,#Div0,#Div0,#Div0
wanted,0,0,3,0,3,#Div0,#Div0,#Div0
discovered,0,0,3,0,3,#Div0,#Div0,#Div0
told,0,0,9,0,9,#Div0,#Div0,#Div0
Concerning,0,0,1,0,1,#Div0,#Div0,#Div0
replace,0,0,1,0,1,#Div0,#Div0,#Div0
prohibited,0,0,1,0,1,#Div0,#Div0,#Div0
features,0,0,4,0,4,#Div0,#Div0,#Div0
enhance,0,0,2,0,2,#Div0,#Div0,#Div0
politic,0,0,1,0,1,#Div0,#Div0,#Div0
afternoon,0,0,1,0,1,#Div0,#Div0,#Div0
fullfilling,0,0,1,1,2,#Div0,0.0,#Div0
adding,0,0,1,0,1,#Div0,#Div0,#Div0
labor,0,0,1,0,1,#Div0,#Div0,#Div0
class,0,0,4,0,4,#Div0,#Div0,#Div0
planning,0,0,4,0,4,#Div0,#Div0,#Div0
tp,0,0,1,0,1,#Div0,#Div0,#Div0
died,0,0,1,0,1,#Div0,#Div0,#Div0
beauty,0,0,2,0,2,#Div0,#Div0,#Div0
conduct,0,0,0,1,1,#Div0,0.0,#Div0
proactive,0,0,1,0,1,#Div0,#Div0,#Div0
record,0,0,1,0,1,#Div0,#Div0,#Div0
cream,0,0,1,0,1,#Div0,#Div0,#Div0
innovated,0,0,1,0,1,#Div0,#Div0,#Div0
compete,0,0,1,1,2,#Div0,0.0,#Div0
studying,0,9,13,0,22,0.0,#Div0,#Div0
finding,0,0,2,2,4,#Div0,0.0,#Div0
geographic,0,0,1,0,1,#Div0,#Div0,#Div0
furniture,0,0,1,0,1,#Div0,#Div0,#Div0
foreign,0,0,8,0,8,#Div0,#Div0,#Div0
goods,0,0,1,0,1,#Div0,#Div0,#Div0
Oman,0,0,1,0,1,#Div0,#Div0,#Div0
hav,0,0,1,0,1,#Div0,#Div0,#Div0
practice,0,0,2,0,2,#Div0,#Div0,#Div0
white-colored,0,0,1,0,1,#Div0,#Div0,#Div0
sink,0,1,0,0,1,0.0,#Div0,#Div0
fellow,0,0,1,0,1,#Div0,#Div0,#Div0
Jr,0,0,1,0,1,#Div0,#Div0,#Div0
age,0,0,1,1,2,#Div0,0.0,#Div0
Such,0,0,2,0,2,#Div0,#Div0,#Div0
vote,0,0,1,0,1,#Div0,#Div0,#Div0
regret,0,0,1,0,1,#Div0,#Div0,#Div0
arm,0,0,1,0,1,#Div0,#Div0,#Div0
misleading,0,0,1,4,5,#Div0,0.0,#Div0
fruitful,0,0,0,2,2,#Div0,0.0,#Div0
experiencing,0,0,2,0,2,#Div0,#Div0,#Div0
questions,0,0,1,0,1,#Div0,#Div0,#Div0
mountainous,0,0,1,0,1,#Div0,#Div0,#Div0
succeed,0,0,10,0,10,#Div0,#Div0,#Div0
appreciated,0,0,1,0,1,#Div0,#Div0,#Div0
confines,0,0,0,1,1,#Div0,0.0,#Div0
appear,0,0,1,0,1,#Div0,#Div0,#Div0
thought,0,0,8,0,8,#Div0,#Div0,#Div0
learning,0,0,35,0,35,#Div0,#Div0,#Div0
availability,0,0,2,0,2,#Div0,#Div0,#Div0
companys,0,1,1,0,2,0.0,#Div0,#Div0
governments,0,0,1,0,1,#Div0,#Div0,#Div0
chapter,0,0,1,0,1,#Div0,#Div0,#Div0
Nightingale,0,0,1,0,1,#Div0,#Div0,#Div0
beautiful,0,0,5,0,5,#Div0,#Div0,#Div0
stuffed,0,0,0,1,1,#Div0,0.0,#Div0
intimacy,0,0,1,0,1,#Div0,#Div0,#Div0
belong,0,0,0,4,4,#Div0,0.0,#Div0
Assets,0,0,1,0,1,#Div0,#Div0,#Div0
taught,0,0,7,1,8,#Div0,0.0,#Div0
technology,0,1,1,0,2,0.0,#Div0,#Div0
supervise,0,0,1,0,1,#Div0,#Div0,#Div0
brilliant,0,0,1,0,1,#Div0,#Div0,#Div0
ensuring,0,0,1,0,1,#Div0,#Div0,#Div0
action,0,0,1,0,1,#Div0,#Div0,#Div0
received,0,0,7,0,7,#Div0,#Div0,#Div0
pass,0,0,1,1,2,#Div0,0.0,#Div0
ridiculous,0,0,1,0,1,#Div0,#Div0,#Div0
competing,0,0,0,2,2,#Div0,0.0,#Div0
found,0,0,19,1,20,#Div0,0.0,#Div0
cost,0,0,7,0,7,#Div0,#Div0,#Div0
safe,0,0,1,1,2,#Div0,0.0,#Div0
complex,0,0,1,0,1,#Div0,#Div0,#Div0
concept,0,0,3,0,3,#Div0,#Div0,#Div0
avoiding,0,0,3,0,3,#Div0,#Div0,#Div0
era,0,0,0,3,3,#Div0,0.0,#Div0
remarkable,0,0,1,0,1,#Div0,#Div0,#Div0
complete,0,0,4,1,5,#Div0,0.0,#Div0
rates,0,0,1,0,1,#Div0,#Div0,#Div0
repeating,0,0,3,0,3,#Div0,#Div0,#Div0
pictures,0,0,0,1,1,#Div0,0.0,#Div0
image,0,0,1,1,2,#Div0,0.0,#Div0
orginal,0,0,1,0,1,#Div0,#Div0,#Div0
odd,0,0,1,0,1,#Div0,#Div0,#Div0
worldwide-best-seller,0,0,1,0,1,#Div0,#Div0,#Div0
defend,0,0,0,1,1,#Div0,0.0,#Div0
imitate,0,0,1,0,1,#Div0,#Div0,#Div0
meaningless,0,0,0,1,1,#Div0,0.0,#Div0
members,0,0,5,0,5,#Div0,#Div0,#Div0
scarce,0,0,1,0,1,#Div0,#Div0,#Div0
cases,0,0,1,0,1,#Div0,#Div0,#Div0
represented,0,0,2,0,2,#Div0,#Div0,#Div0
organize,0,0,10,0,10,#Div0,#Div0,#Div0
few,0,1,26,0,27,0.0,#Div0,#Div0
engine,0,0,0,2,2,#Div0,0.0,#Div0
Itza,0,0,1,0,1,#Div0,#Div0,#Div0
believes,0,0,2,0,2,#Div0,#Div0,#Div0
Alot,0,0,1,0,1,#Div0,#Div0,#Div0
eloquent,0,0,0,1,1,#Div0,0.0,#Div0
crowded,0,0,2,0,2,#Div0,#Div0,#Div0
activate,0,0,0,1,1,#Div0,0.0,#Div0
way,0,0,10,1,11,#Div0,0.0,#Div0
conducts,0,0,1,0,1,#Div0,#Div0,#Div0
acidic,0,0,1,0,1,#Div0,#Div0,#Div0
attention,0,0,1,0,1,#Div0,#Div0,#Div0
spread-out,0,0,0,1,1,#Div0,0.0,#Div0
grows,0,0,0,1,1,#Div0,0.0,#Div0
becasue,0,0,1,0,1,#Div0,#Div0,#Div0
resorts,0,0,1,0,1,#Div0,#Div0,#Div0
sustain,0,0,0,1,1,#Div0,0.0,#Div0
against,0,0,0,1,1,#Div0,0.0,#Div0
trend,0,0,1,0,1,#Div0,#Div0,#Div0
inconvenient,0,0,1,0,1,#Div0,#Div0,#Div0
ignore,0,0,2,0,2,#Div0,#Div0,#Div0
environment-friendly,0,0,1,0,1,#Div0,#Div0,#Div0
respect,0,0,3,2,5,#Div0,0.0,#Div0
broad,0,0,0,56,56,#Div0,0.0,#Div0
member,0,0,4,0,4,#Div0,#Div0,#Div0
interested,0,1,1,0,2,0.0,#Div0,#Div0
enjoying,0,0,14,0,14,#Div0,#Div0,#Div0
mnemonic,0,0,1,0,1,#Div0,#Div0,#Div0
skilled,0,0,1,0,1,#Div0,#Div0,#Div0
involved,0,0,7,0,7,#Div0,#Div0,#Div0
scarcity,0,0,1,0,1,#Div0,#Div0,#Div0
divided,0,0,0,1,1,#Div0,0.0,#Div0
commute,0,0,1,0,1,#Div0,#Div0,#Div0
stupid,0,0,0,1,1,#Div0,0.0,#Div0
exploring,1,0,0,1,2,1.0,0.5,0.6666666666666666
everyone,0,0,1,0,1,#Div0,#Div0,#Div0
decreased,0,0,1,0,1,#Div0,#Div0,#Div0
twentieth,0,0,3,0,3,#Div0,#Div0,#Div0
helps,0,0,11,0,11,#Div0,#Div0,#Div0
live,0,0,30,0,30,#Div0,#Div0,#Div0
wearing,0,0,1,0,1,#Div0,#Div0,#Div0
allocating,0,0,0,1,1,#Div0,0.0,#Div0
away,0,0,0,1,1,#Div0,0.0,#Div0
sense,0,0,6,0,6,#Div0,#Div0,#Div0
asset,0,0,0,1,1,#Div0,0.0,#Div0
dosent,0,0,1,0,1,#Div0,#Div0,#Div0
simulate,0,0,1,0,1,#Div0,#Div0,#Div0
kills,0,0,1,0,1,#Div0,#Div0,#Div0
preserving,0,0,0,1,1,#Div0,0.0,#Div0
realizing,0,0,1,0,1,#Div0,#Div0,#Div0
wiping,0,0,2,0,2,#Div0,#Div0,#Div0
notice,0,0,1,0,1,#Div0,#Div0,#Div0
resembles,0,0,1,0,1,#Div0,#Div0,#Div0
extend,0,0,0,1,1,#Div0,0.0,#Div0
belive,0,0,4,0,4,#Div0,#Div0,#Div0
great,0,0,19,1,20,#Div0,0.0,#Div0
compared,0,2,4,0,6,0.0,#Div0,#Div0
Government,0,0,1,0,1,#Div0,#Div0,#Div0
coordinating,0,0,0,1,1,#Div0,0.0,#Div0
forbidden,0,0,1,0,1,#Div0,#Div0,#Div0
Getting,0,0,0,1,1,#Div0,0.0,#Div0
necessary,0,0,5,0,5,#Div0,#Div0,#Div0
site,0,0,3,0,3,#Div0,#Div0,#Div0
turned,0,0,1,0,1,#Div0,#Div0,#Div0
faces,0,0,0,3,3,#Div0,0.0,#Div0
mechanical,0,0,2,0,2,#Div0,#Div0,#Div0
memorizing,0,0,7,0,7,#Div0,#Div0,#Div0
till,0,0,1,0,1,#Div0,#Div0,#Div0
next,0,0,7,0,7,#Div0,#Div0,#Div0
populating,0,0,1,0,1,#Div0,#Div0,#Div0
have,0,0,377,74,451,#Div0,0.0,#Div0
imagine,0,0,4,0,4,#Div0,#Div0,#Div0
green-house,0,0,0,1,1,#Div0,0.0,#Div0
fill,1,0,0,1,2,1.0,0.5,0.6666666666666666
ultimate,0,0,1,0,1,#Div0,#Div0,#Div0
chooses,0,0,1,0,1,#Div0,#Div0,#Div0
plan,0,0,16,0,16,#Div0,#Div0,#Div0
undestand,0,0,3,0,3,#Div0,#Div0,#Div0
tire,0,0,1,0,1,#Div0,#Div0,#Div0
physiological,0,0,1,0,1,#Div0,#Div0,#Div0
whats,0,0,1,0,1,#Div0,#Div0,#Div0
estimated,0,0,1,0,1,#Div0,#Div0,#Div0
agree,0,0,85,0,85,#Div0,#Div0,#Div0
end,0,0,5,3,8,#Div0,0.0,#Div0
transporting,0,0,2,0,2,#Div0,#Div0,#Div0
constructed,0,0,1,0,1,#Div0,#Div0,#Div0
facts,0,0,3,0,3,#Div0,#Div0,#Div0
nurse,0,0,1,0,1,#Div0,#Div0,#Div0
limitation,0,0,1,0,1,#Div0,#Div0,#Div0
truly,0,0,1,0,1,#Div0,#Div0,#Div0
fist,0,0,2,0,2,#Div0,#Div0,#Div0
boosted,0,0,0,1,1,#Div0,0.0,#Div0
reveals,0,0,0,2,2,#Div0,0.0,#Div0
pair,0,0,1,0,1,#Div0,#Div0,#Div0
wherever,0,0,1,0,1,#Div0,#Div0,#Div0
paid,0,0,3,0,3,#Div0,#Div0,#Div0
division,0,0,2,0,2,#Div0,#Div0,#Div0
improving,0,0,5,0,5,#Div0,#Div0,#Div0
irrespective,0,0,1,0,1,#Div0,#Div0,#Div0
stated,0,0,6,0,6,#Div0,#Div0,#Div0
father,0,0,1,0,1,#Div0,#Div0,#Div0
stores,0,0,0,1,1,#Div0,0.0,#Div0
innovative,0,0,4,0,4,#Div0,#Div0,#Div0
bring,0,0,4,4,8,#Div0,0.0,#Div0
straight,0,0,0,1,1,#Div0,0.0,#Div0
pollution,0,0,1,0,1,#Div0,#Div0,#Div0
volunteering,0,0,3,0,3,#Div0,#Div0,#Div0
skied,0,0,1,0,1,#Div0,#Div0,#Div0
interests,0,1,0,0,1,0.0,#Div0,#Div0
bunch,0,0,1,0,1,#Div0,#Div0,#Div0
gulf,0,0,1,0,1,#Div0,#Div0,#Div0
singing,0,0,2,0,2,#Div0,#Div0,#Div0
planes,0,0,1,0,1,#Div0,#Div0,#Div0
its,0,0,0,1,1,#Div0,0.0,#Div0
develop,0,0,6,7,13,#Div0,0.0,#Div0
courses,0,0,1,0,1,#Div0,#Div0,#Div0
guid,0,0,1,0,1,#Div0,#Div0,#Div0
importance,0,0,8,0,8,#Div0,#Div0,#Div0
brings,0,0,9,1,10,#Div0,0.0,#Div0
other,0,0,134,0,134,#Div0,#Div0,#Div0
wih,0,0,1,0,1,#Div0,#Div0,#Div0
optimistic,0,0,1,0,1,#Div0,#Div0,#Div0
leader,0,0,1,0,1,#Div0,#Div0,#Div0
outside,0,0,0,1,1,#Div0,0.0,#Div0
withdrawal,0,1,0,0,1,0.0,#Div0,#Div0
culture,0,0,2,0,2,#Div0,#Div0,#Div0
fiction,0,0,1,0,1,#Div0,#Div0,#Div0
Travelling,0,0,3,0,3,#Div0,#Div0,#Div0
maintaining,0,0,0,1,1,#Div0,0.0,#Div0
benefits,0,0,1,0,1,#Div0,#Div0,#Div0
layer,0,1,0,0,1,0.0,#Div0,#Div0
activitiy,0,0,1,0,1,#Div0,#Div0,#Div0
want,0,0,58,0,58,#Div0,#Div0,#Div0
principle,0,0,1,0,1,#Div0,#Div0,#Div0
formed,0,0,0,1,1,#Div0,0.0,#Div0
shiny,0,0,1,1,2,#Div0,0.0,#Div0
books,0,0,3,0,3,#Div0,#Div0,#Div0
waste,0,0,0,6,6,#Div0,0.0,#Div0
encouraging,0,0,1,0,1,#Div0,#Div0,#Div0
fundamental,0,0,0,1,1,#Div0,0.0,#Div0
exposed,0,0,0,1,1,#Div0,0.0,#Div0
stand,0,0,1,2,3,#Div0,0.0,#Div0
diverted,0,0,0,1,1,#Div0,0.0,#Div0
unnatural,0,0,1,0,1,#Div0,#Div0,#Div0
applied,0,0,1,0,1,#Div0,#Div0,#Div0
prospective,0,0,1,0,1,#Div0,#Div0,#Div0
enlargement,0,0,0,1,1,#Div0,0.0,#Div0
eating,0,0,2,0,2,#Div0,#Div0,#Div0
virtue,0,0,0,1,1,#Div0,0.0,#Div0
fit,0,0,0,2,2,#Div0,0.0,#Div0
disagreed,0,0,1,0,1,#Div0,#Div0,#Div0
grade,0,0,1,1,2,#Div0,0.0,#Div0
group,0,0,17,0,17,#Div0,#Div0,#Div0
estimates,0,0,1,0,1,#Div0,#Div0,#Div0
dangerous,0,0,0,2,2,#Div0,0.0,#Div0
material,0,0,1,0,1,#Div0,#Div0,#Div0
expecting,0,0,1,0,1,#Div0,#Div0,#Div0
former,0,0,1,0,1,#Div0,#Div0,#Div0
Many,0,0,10,0,10,#Div0,#Div0,#Div0
worry,0,0,2,0,2,#Div0,#Div0,#Div0
introducing,0,0,1,0,1,#Div0,#Div0,#Div0
up,0,0,0,3,3,#Div0,0.0,#Div0
curly,0,0,1,0,1,#Div0,#Div0,#Div0
couple,0,0,3,0,3,#Div0,#Div0,#Div0
Theoretical,0,0,1,0,1,#Div0,#Div0,#Div0
energy,0,0,1,0,1,#Div0,#Div0,#Div0
believed,0,0,5,0,5,#Div0,#Div0,#Div0
spot,0,0,0,1,1,#Div0,0.0,#Div0
satisfaction,0,0,2,0,2,#Div0,#Div0,#Div0
daily,0,0,5,0,5,#Div0,#Div0,#Div0
forming,0,0,0,3,3,#Div0,0.0,#Div0
spreading,0,0,0,1,1,#Div0,0.0,#Div0
main,0,0,17,0,17,#Div0,#Div0,#Div0
changing,0,0,9,0,9,#Div0,#Div0,#Div0
too,0,0,0,1,1,#Div0,0.0,#Div0
dominated,1,0,0,0,1,1.0,1.0,1.0
growth,0,0,3,3,6,#Div0,0.0,#Div0
asking,0,0,3,0,3,#Div0,#Div0,#Div0
Passing,0,0,1,0,1,#Div0,#Div0,#Div0
clever,0,0,1,0,1,#Div0,#Div0,#Div0
test,0,0,1,0,1,#Div0,#Div0,#Div0
riding,0,0,1,0,1,#Div0,#Div0,#Div0
introduced,0,0,1,2,3,#Div0,0.0,#Div0
exceed,0,0,1,0,1,#Div0,#Div0,#Div0
ones,0,0,2,0,2,#Div0,#Div0,#Div0
museums,0,0,1,0,1,#Div0,#Div0,#Div0
struck,0,0,0,1,1,#Div0,0.0,#Div0
visits,0,0,1,0,1,#Div0,#Div0,#Div0
Sources,0,0,0,1,1,#Div0,0.0,#Div0
scientific,0,0,6,0,6,#Div0,#Div0,#Div0
last,0,0,8,1,9,#Div0,0.0,#Div0
putting,0,0,0,2,2,#Div0,0.0,#Div0
achieve,0,0,9,0,9,#Div0,#Div0,#Div0
frequent,0,0,1,0,1,#Div0,#Div0,#Div0
lacking,0,0,1,0,1,#Div0,#Div0,#Div0
give,0,0,28,34,62,#Div0,0.0,#Div0
forthcoming,0,0,1,0,1,#Div0,#Div0,#Div0
re,0,0,6,0,6,#Div0,#Div0,#Div0
healthy,0,0,0,1,1,#Div0,0.0,#Div0
delighted,0,0,1,0,1,#Div0,#Div0,#Div0
crucial,0,0,1,0,1,#Div0,#Div0,#Div0
keening,0,0,1,0,1,#Div0,#Div0,#Div0
sophisticated,0,0,2,0,2,#Div0,#Div0,#Div0
official,0,0,2,0,2,#Div0,#Div0,#Div0
carry,0,0,0,2,2,#Div0,0.0,#Div0
uncontrollable,0,0,1,0,1,#Div0,#Div0,#Div0
figured,0,0,1,0,1,#Div0,#Div0,#Div0
skills,0,0,5,0,5,#Div0,#Div0,#Div0
dragged,0,0,0,1,1,#Div0,0.0,#Div0
conditioners,0,1,0,0,1,0.0,#Div0,#Div0
restrict,0,0,1,1,2,#Div0,0.0,#Div0
advantage,0,0,2,0,2,#Div0,#Div0,#Div0
back,0,0,0,1,1,#Div0,0.0,#Div0
shop,0,0,2,0,2,#Div0,#Div0,#Div0
functions,0,0,2,0,2,#Div0,#Div0,#Div0
am,0,0,43,0,43,#Div0,#Div0,#Div0
dear,0,0,1,0,1,#Div0,#Div0,#Div0
responsibilties,0,0,1,0,1,#Div0,#Div0,#Div0
shrugged,0,0,0,1,1,#Div0,0.0,#Div0
speak,0,3,10,0,13,0.0,#Div0,#Div0
repaired,0,0,0,1,1,#Div0,0.0,#Div0
beacuse,0,0,1,0,1,#Div0,#Div0,#Div0
environment,0,0,1,0,1,#Div0,#Div0,#Div0
wiil,0,0,2,0,2,#Div0,#Div0,#Div0
seeing,0,0,6,0,6,#Div0,#Div0,#Div0
connecting,0,0,0,1,1,#Div0,0.0,#Div0
economic,0,0,6,0,6,#Div0,#Div0,#Div0
had,0,0,48,1,49,#Div0,0.0,#Div0
lapses,0,0,1,0,1,#Div0,#Div0,#Div0
existing,0,0,1,0,1,#Div0,#Div0,#Div0
render,0,0,1,0,1,#Div0,#Div0,#Div0
essential,0,0,2,0,2,#Div0,#Div0,#Div0
exhaust,0,0,1,0,1,#Div0,#Div0,#Div0
attractions,0,0,0,1,1,#Div0,0.0,#Div0
bother,0,0,2,0,2,#Div0,#Div0,#Div0
effective,0,0,2,0,2,#Div0,#Div0,#Div0
happening,0,0,5,0,5,#Div0,#Div0,#Div0
come,0,2,14,1,17,0.0,0.0,#Div0
someone,0,0,1,0,1,#Div0,#Div0,#Div0
computer,0,0,3,0,3,#Div0,#Div0,#Div0
electricity-lowered,0,0,1,0,1,#Div0,#Div0,#Div0
liked,0,0,4,0,4,#Div0,#Div0,#Div0
likes,0,0,3,0,3,#Div0,#Div0,#Div0
visit,0,0,16,0,16,#Div0,#Div0,#Div0
adventure,0,0,0,1,1,#Div0,0.0,#Div0
entering,0,0,0,2,2,#Div0,0.0,#Div0
optimize,0,0,0,1,1,#Div0,0.0,#Div0
explosion,0,0,0,1,1,#Div0,0.0,#Div0
society,0,0,1,0,1,#Div0,#Div0,#Div0
treated,0,0,1,0,1,#Div0,#Div0,#Div0
vision,0,0,0,2,2,#Div0,0.0,#Div0
frighten,0,0,1,0,1,#Div0,#Div0,#Div0
films,0,0,1,0,1,#Div0,#Div0,#Div0
Center,0,0,1,0,1,#Div0,#Div0,#Div0
Next,0,0,1,0,1,#Div0,#Div0,#Div0
dedicated,0,0,1,0,1,#Div0,#Div0,#Div0
approved,0,0,2,0,2,#Div0,#Div0,#Div0
varied,0,0,1,0,1,#Div0,#Div0,#Div0
sixty,0,0,1,0,1,#Div0,#Div0,#Div0
feel,0,0,37,3,40,#Div0,0.0,#Div0
promise,0,0,1,0,1,#Div0,#Div0,#Div0
ears,0,0,1,0,1,#Div0,#Div0,#Div0
given,0,0,7,1,8,#Div0,0.0,#Div0
preventing,0,0,1,0,1,#Div0,#Div0,#Div0
specialize,0,0,19,0,19,#Div0,#Div0,#Div0
useless,0,0,2,2,4,#Div0,0.0,#Div0
unexpected,0,0,1,0,1,#Div0,#Div0,#Div0
moved,0,0,3,2,5,#Div0,0.0,#Div0
compel,0,0,0,1,1,#Div0,0.0,#Div0
degree,0,0,3,0,3,#Div0,#Div0,#Div0
show,0,0,17,0,17,#Div0,#Div0,#Div0
reassuring,0,0,1,0,1,#Div0,#Div0,#Div0
care,0,5,9,0,14,0.0,#Div0,#Div0
consumption,0,0,1,0,1,#Div0,#Div0,#Div0
high,0,0,19,1,20,#Div0,0.0,#Div0
caveman,0,0,1,0,1,#Div0,#Div0,#Div0
eliminates,0,0,0,2,2,#Div0,0.0,#Div0
Increasing,0,0,1,0,1,#Div0,#Div0,#Div0
empower,0,0,1,0,1,#Div0,#Div0,#Div0
master,0,0,0,1,1,#Div0,0.0,#Div0
classic,0,0,1,0,1,#Div0,#Div0,#Div0
result,0,0,2,0,2,#Div0,#Div0,#Div0
likely,0,0,1,0,1,#Div0,#Div0,#Div0
represents,0,0,3,0,3,#Div0,#Div0,#Div0
stimulate,0,0,1,0,1,#Div0,#Div0,#Div0
vehicle,0,0,1,0,1,#Div0,#Div0,#Div0
trucks,0,0,0,1,1,#Div0,0.0,#Div0
beauties,0,0,1,0,1,#Div0,#Div0,#Div0
news,0,0,1,0,1,#Div0,#Div0,#Div0
south,0,0,1,0,1,#Div0,#Div0,#Div0
simple,0,0,8,1,9,#Div0,0.0,#Div0
position,0,0,1,0,1,#Div0,#Div0,#Div0
students,0,0,4,0,4,#Div0,#Div0,#Div0
worried,0,0,2,0,2,#Div0,#Div0,#Div0
creative,0,0,4,0,4,#Div0,#Div0,#Div0
M,0,0,1,0,1,#Div0,#Div0,#Div0
creation,0,0,1,0,1,#Div0,#Div0,#Div0
acquired,0,0,2,1,3,#Div0,0.0,#Div0
appeared,0,0,1,0,1,#Div0,#Div0,#Div0
known,0,0,15,0,15,#Div0,#Div0,#Div0
blame,0,0,1,0,1,#Div0,#Div0,#Div0
discuss,0,0,3,0,3,#Div0,#Div0,#Div0
forms,0,0,1,0,1,#Div0,#Div0,#Div0
follow,0,0,0,10,10,#Div0,0.0,#Div0
technique,0,0,1,0,1,#Div0,#Div0,#Div0
connect,0,0,0,3,3,#Div0,0.0,#Div0
justified,0,0,1,0,1,#Div0,#Div0,#Div0
selling,0,0,2,1,3,#Div0,0.0,#Div0
analyzing,0,1,2,0,3,0.0,#Div0,#Div0
releated,0,0,1,0,1,#Div0,#Div0,#Div0
stood,0,0,0,1,1,#Div0,0.0,#Div0
cooked,0,0,2,0,2,#Div0,#Div0,#Div0
develope,0,0,4,1,5,#Div0,0.0,#Div0
forty,0,0,1,0,1,#Div0,#Div0,#Div0
stat,0,0,1,0,1,#Div0,#Div0,#Div0
examples,0,0,2,0,2,#Div0,#Div0,#Div0
marginal,0,0,0,1,1,#Div0,0.0,#Div0
thay,0,0,1,0,1,#Div0,#Div0,#Div0
path,0,0,0,2,2,#Div0,0.0,#Div0
illustrated,0,0,1,2,3,#Div0,0.0,#Div0
tools,0,0,0,1,1,#Div0,0.0,#Div0
realy,0,0,1,0,1,#Div0,#Div0,#Div0
poeple,0,0,1,0,1,#Div0,#Div0,#Div0
picturize,0,0,0,1,1,#Div0,0.0,#Div0
Effect,0,0,1,0,1,#Div0,#Div0,#Div0
service,0,0,1,0,1,#Div0,#Div0,#Div0
usual,0,0,3,0,3,#Div0,#Div0,#Div0
influenced,0,0,2,0,2,#Div0,#Div0,#Div0
airlines,0,0,1,0,1,#Div0,#Div0,#Div0
knew,0,0,1,0,1,#Div0,#Div0,#Div0
learns,0,0,3,0,3,#Div0,#Div0,#Div0
spends,0,0,1,1,2,#Div0,0.0,#Div0
restricted,0,0,0,3,3,#Div0,0.0,#Div0
neo,0,0,1,0,1,#Div0,#Div0,#Div0
underline,0,0,0,1,1,#Div0,0.0,#Div0
agricultural,0,0,1,0,1,#Div0,#Div0,#Div0
withdraw,0,1,0,0,1,0.0,#Div0,#Div0
organized,0,0,4,0,4,#Div0,#Div0,#Div0
wall,0,0,1,0,1,#Div0,#Div0,#Div0
demanding,0,0,0,1,1,#Div0,0.0,#Div0
determine,0,0,1,0,1,#Div0,#Div0,#Div0
invented,0,0,3,0,3,#Div0,#Div0,#Div0
interrupting,0,0,1,0,1,#Div0,#Div0,#Div0
consuming,0,0,1,0,1,#Div0,#Div0,#Div0
samples,0,0,1,0,1,#Div0,#Div0,#Div0
suggests,0,0,1,0,1,#Div0,#Div0,#Div0
non,0,0,2,0,2,#Div0,#Div0,#Div0
times,0,0,2,0,2,#Div0,#Div0,#Div0
overcome,0,0,0,3,3,#Div0,0.0,#Div0
awful,0,0,1,0,1,#Div0,#Div0,#Div0
build,0,0,4,6,10,#Div0,0.0,#Div0
Following,0,0,2,0,2,#Div0,#Div0,#Div0
Becasue,0,0,1,0,1,#Div0,#Div0,#Div0
married,0,1,1,0,2,0.0,#Div0,#Div0
down,0,0,0,1,1,#Div0,0.0,#Div0
front,0,1,1,0,2,0.0,#Div0,#Div0
shoping,0,0,1,0,1,#Div0,#Div0,#Div0
overpushed,0,0,0,1,1,#Div0,0.0,#Div0
memorize,0,0,5,0,5,#Div0,#Div0,#Div0
increased,0,0,3,0,3,#Div0,#Div0,#Div0
contain,0,0,1,0,1,#Div0,#Div0,#Div0
tried,0,0,12,0,12,#Div0,#Div0,#Div0
responds,0,0,0,1,1,#Div0,0.0,#Div0
greets,0,1,0,0,1,0.0,#Div0,#Div0
broader,0,0,0,1,1,#Div0,0.0,#Div0
dissapointed,0,0,1,0,1,#Div0,#Div0,#Div0
tones,0,0,0,2,2,#Div0,0.0,#Div0
lost,0,0,10,3,13,#Div0,0.0,#Div0
historic,0,0,1,0,1,#Div0,#Div0,#Div0
mine,0,0,2,0,2,#Div0,#Div0,#Div0
developped,0,0,1,0,1,#Div0,#Div0,#Div0
pointed,0,0,1,0,1,#Div0,#Div0,#Div0
turn,0,0,1,3,4,#Div0,0.0,#Div0
containing,0,0,1,0,1,#Div0,#Div0,#Div0
widening,0,0,0,1,1,#Div0,0.0,#Div0
hypothetical,0,0,1,0,1,#Div0,#Div0,#Div0
creams,0,0,1,0,1,#Div0,#Div0,#Div0
form,0,0,5,1,6,#Div0,0.0,#Div0
practicing,0,0,2,0,2,#Div0,#Div0,#Div0
attend,0,0,5,0,5,#Div0,#Div0,#Div0
manner,0,0,1,0,1,#Div0,#Div0,#Div0
haver,0,0,1,0,1,#Div0,#Div0,#Div0
concerned,0,0,2,0,2,#Div0,#Div0,#Div0
weak,0,0,0,1,1,#Div0,0.0,#Div0
cluster,0,0,1,0,1,#Div0,#Div0,#Div0
specified,0,0,2,0,2,#Div0,#Div0,#Div0
depends,0,0,6,0,6,#Div0,#Div0,#Div0
Intelligent,0,0,1,0,1,#Div0,#Div0,#Div0
entitled,0,0,1,0,1,#Div0,#Div0,#Div0
others,0,0,1,0,1,#Div0,#Div0,#Div0
arrive,0,1,1,0,2,0.0,#Div0,#Div0
totaly,0,0,1,0,1,#Div0,#Div0,#Div0
engaged,0,0,3,0,3,#Div0,#Div0,#Div0
educated,0,0,8,0,8,#Div0,#Div0,#Div0
hobby,0,0,1,0,1,#Div0,#Div0,#Div0
various,0,5,6,0,11,0.0,#Div0,#Div0
wonderfull,0,0,1,0,1,#Div0,#Div0,#Div0
presented,0,0,5,0,5,#Div0,#Div0,#Div0
program,0,0,5,0,5,#Div0,#Div0,#Div0
nowdays,0,0,2,0,2,#Div0,#Div0,#Div0
spending,0,0,0,7,7,#Div0,0.0,#Div0
representative,0,0,2,0,2,#Div0,#Div0,#Div0
sum,0,0,6,0,6,#Div0,#Div0,#Div0
obtain,0,0,4,4,8,#Div0,0.0,#Div0
systems,0,0,5,0,5,#Div0,#Div0,#Div0
remote,0,0,1,1,2,#Div0,0.0,#Div0
topic,0,0,2,0,2,#Div0,#Div0,#Div0
owns,0,0,1,0,1,#Div0,#Div0,#Div0
involves,0,0,3,0,3,#Div0,#Div0,#Div0
meant,0,0,1,0,1,#Div0,#Div0,#Div0
noisy,0,0,2,0,2,#Div0,#Div0,#Div0
traditional,0,0,1,0,1,#Div0,#Div0,#Div0
catastrophic,0,0,0,1,1,#Div0,0.0,#Div0
is,0,0,636,1,637,#Div0,0.0,#Div0
schedule,0,0,4,0,4,#Div0,#Div0,#Div0
wasting,0,0,0,2,2,#Div0,0.0,#Div0
graphic,0,0,4,0,4,#Div0,#Div0,#Div0
represent,0,0,2,0,2,#Div0,#Div0,#Div0
less,0,0,1,0,1,#Div0,#Div0,#Div0
canals,0,0,1,0,1,#Div0,#Div0,#Div0
meaning,0,0,4,0,4,#Div0,#Div0,#Div0
seems,0,0,10,0,10,#Div0,#Div0,#Div0
softer,0,0,1,0,1,#Div0,#Div0,#Div0
recommended,0,0,1,0,1,#Div0,#Div0,#Div0
proportioned,0,0,0,1,1,#Div0,0.0,#Div0
strong,0,0,1,18,19,#Div0,0.0,#Div0
believe,0,0,64,0,64,#Div0,#Div0,#Div0
rubbed,0,0,2,0,2,#Div0,#Div0,#Div0
most,0,0,0,1,1,#Div0,0.0,#Div0
parts,0,0,1,0,1,#Div0,#Div0,#Div0
full,0,0,3,5,8,#Div0,0.0,#Div0
socialize,0,0,2,0,2,#Div0,#Div0,#Div0
focus,0,0,0,8,8,#Div0,0.0,#Div0
many,0,27,172,0,199,0.0,#Div0,#Div0
COMPLETE,0,0,1,0,1,#Div0,#Div0,#Div0
theoretical,0,0,3,0,3,#Div0,#Div0,#Div0
function,0,0,2,0,2,#Div0,#Div0,#Div0
actress,0,0,1,0,1,#Div0,#Div0,#Div0
reasonable,0,0,1,0,1,#Div0,#Div0,#Div0
Use,0,0,0,1,1,#Div0,0.0,#Div0
arising,0,0,1,0,1,#Div0,#Div0,#Div0
produce,0,0,7,1,8,#Div0,0.0,#Div0
flying,0,0,0,1,1,#Div0,0.0,#Div0
negative,0,0,9,0,9,#Div0,#Div0,#Div0
usefulness,0,0,1,0,1,#Div0,#Div0,#Div0
talked,0,1,2,0,3,0.0,#Div0,#Div0
potentials,0,0,0,2,2,#Div0,0.0,#Div0
juice,0,0,1,0,1,#Div0,#Div0,#Div0
draw,0,0,1,1,2,#Div0,0.0,#Div0
unions,0,0,1,0,1,#Div0,#Div0,#Div0
indirect,0,0,1,0,1,#Div0,#Div0,#Div0
d,0,0,5,0,5,#Div0,#Div0,#Div0
throw,0,0,0,1,1,#Div0,0.0,#Div0
expectations,0,0,1,0,1,#Div0,#Div0,#Div0
acts,0,0,1,0,1,#Div0,#Div0,#Div0
opener,0,0,0,1,1,#Div0,0.0,#Div0
transport,0,0,4,0,4,#Div0,#Div0,#Div0
suggest,0,0,5,0,5,#Div0,#Div0,#Div0
Suppose,0,0,1,0,1,#Div0,#Div0,#Div0
answered,0,0,1,0,1,#Div0,#Div0,#Div0
exceeds,0,0,1,0,1,#Div0,#Div0,#Div0
Inter,0,0,1,0,1,#Div0,#Div0,#Div0
math,0,0,1,0,1,#Div0,#Div0,#Div0
rough,0,0,1,1,2,#Div0,0.0,#Div0
resolve,0,0,1,0,1,#Div0,#Div0,#Div0
weight,0,0,0,1,1,#Div0,0.0,#Div0
supposed,0,0,2,0,2,#Div0,#Div0,#Div0
Based,0,0,1,0,1,#Div0,#Div0,#Div0
imposible,0,0,1,0,1,#Div0,#Div0,#Div0
pretends,0,0,1,0,1,#Div0,#Div0,#Div0
use,0,0,54,1,55,#Div0,0.0,#Div0
address,0,0,1,0,1,#Div0,#Div0,#Div0
resolving,0,0,1,0,1,#Div0,#Div0,#Div0
tranport,0,0,1,0,1,#Div0,#Div0,#Div0
serve,0,0,0,3,3,#Div0,0.0,#Div0
makes,0,0,19,0,19,#Div0,#Div0,#Div0
school,0,0,3,0,3,#Div0,#Div0,#Div0
exceptions,0,0,1,0,1,#Div0,#Div0,#Div0
imposed,0,0,0,1,1,#Div0,0.0,#Div0
ethical,0,0,2,0,2,#Div0,#Div0,#Div0
spread,0,0,1,4,5,#Div0,0.0,#Div0
Trying,0,0,1,0,1,#Div0,#Div0,#Div0
wipe,0,0,1,0,1,#Div0,#Div0,#Div0
topics,0,0,1,0,1,#Div0,#Div0,#Div0
pattern,0,0,1,0,1,#Div0,#Div0,#Div0
interacting,0,0,2,0,2,#Div0,#Div0,#Div0
ather,0,0,1,0,1,#Div0,#Div0,#Div0
looked,0,0,2,0,2,#Div0,#Div0,#Div0
practiced,0,0,4,0,4,#Div0,#Div0,#Div0
like,0,0,27,0,27,#Div0,#Div0,#Div0
laptops,0,0,2,0,2,#Div0,#Div0,#Div0
distinguishing,0,0,1,0,1,#Div0,#Div0,#Div0
facilities,0,0,1,0,1,#Div0,#Div0,#Div0
favorite,0,0,2,0,2,#Div0,#Div0,#Div0
wind,0,0,1,0,1,#Div0,#Div0,#Div0
pew,0,0,1,0,1,#Div0,#Div0,#Div0
limited,0,0,2,5,7,#Div0,0.0,#Div0
occur,0,0,4,0,4,#Div0,#Div0,#Div0
handle,0,0,0,1,1,#Div0,0.0,#Div0
eventualy,0,0,1,0,1,#Div0,#Div0,#Div0
emphasizes,0,0,1,0,1,#Div0,#Div0,#Div0
excited,0,1,2,0,3,0.0,#Div0,#Div0
precious,0,0,1,2,3,#Div0,0.0,#Div0
constant,0,0,2,0,2,#Div0,#Div0,#Div0
protecting,0,0,1,0,1,#Div0,#Div0,#Div0
hereby,0,0,1,0,1,#Div0,#Div0,#Div0
wants,0,0,14,0,14,#Div0,#Div0,#Div0
reflect,0,0,0,2,2,#Div0,0.0,#Div0
sublime,0,1,0,0,1,0.0,#Div0,#Div0
sightseeing,0,0,1,0,1,#Div0,#Div0,#Div0
success,0,0,2,0,2,#Div0,#Div0,#Div0
Shoten,0,0,1,0,1,#Div0,#Div0,#Div0
valued,0,0,0,1,1,#Div0,0.0,#Div0
city,0,0,1,0,1,#Div0,#Div0,#Div0
lead,0,0,4,13,17,#Div0,0.0,#Div0
grew,0,0,1,1,2,#Div0,0.0,#Div0
manipulate,0,0,1,0,1,#Div0,#Div0,#Div0
rich,0,0,3,1,4,#Div0,0.0,#Div0
creats,0,0,1,0,1,#Div0,#Div0,#Div0
birth,0,0,0,1,1,#Div0,0.0,#Div0
bragging,0,0,1,0,1,#Div0,#Div0,#Div0
professor,0,0,1,0,1,#Div0,#Div0,#Div0
survive,0,0,0,1,1,#Div0,0.0,#Div0
wrote,0,0,3,0,3,#Div0,#Div0,#Div0
marketed,0,0,2,0,2,#Div0,#Div0,#Div0
oto,0,0,1,0,1,#Div0,#Div0,#Div0
variety,0,0,6,0,6,#Div0,#Div0,#Div0
increasing,0,0,15,1,16,#Div0,0.0,#Div0
keep,0,0,15,9,24,#Div0,0.0,#Div0
somewhere,0,0,1,0,1,#Div0,#Div0,#Div0
striving,0,0,1,0,1,#Div0,#Div0,#Div0
websites,0,0,1,0,1,#Div0,#Div0,#Div0
basis,0,0,0,3,3,#Div0,0.0,#Div0
everything,0,0,1,0,1,#Div0,#Div0,#Div0
lose,0,0,2,8,10,#Div0,0.0,#Div0
Other,0,0,2,0,2,#Div0,#Div0,#Div0
dedicates,0,0,0,1,1,#Div0,0.0,#Div0
young,0,0,186,0,186,#Div0,#Div0,#Div0
falling,0,0,1,0,1,#Div0,#Div0,#Div0
combining,0,0,2,0,2,#Div0,#Div0,#Div0
improve,0,0,27,0,27,#Div0,#Div0,#Div0
Thats,0,0,1,0,1,#Div0,#Div0,#Div0
services,0,0,2,0,2,#Div0,#Div0,#Div0
sheet,0,0,1,0,1,#Div0,#Div0,#Div0
cheap,0,0,3,2,5,#Div0,0.0,#Div0
enjoyable,0,0,3,0,3,#Div0,#Div0,#Div0
reduce,0,0,0,1,1,#Div0,0.0,#Div0
drop,0,0,0,1,1,#Div0,0.0,#Div0
discover,0,0,2,5,7,#Div0,0.0,#Div0
All,0,0,1,0,1,#Div0,#Div0,#Div0
sector,0,0,1,1,2,#Div0,0.0,#Div0
t,0,0,5,0,5,#Div0,#Div0,#Div0
definition,0,0,1,0,1,#Div0,#Div0,#Div0
pick,0,0,0,2,2,#Div0,0.0,#Div0
security,0,0,1,0,1,#Div0,#Div0,#Div0
academic,0,0,42,0,42,#Div0,#Div0,#Div0
carrier,0,0,0,1,1,#Div0,0.0,#Div0
hold,0,0,0,2,2,#Div0,0.0,#Div0
hand,0,0,0,2,2,#Div0,0.0,#Div0
human,0,0,13,0,13,#Div0,#Div0,#Div0
non-profit,0,0,3,0,3,#Div0,#Div0,#Div0
step,0,0,1,1,2,#Div0,0.0,#Div0
enjoy,0,0,94,0,94,#Div0,#Div0,#Div0
combined,0,0,1,0,1,#Div0,#Div0,#Div0
Simple,0,0,1,0,1,#Div0,#Div0,#Div0
saing,0,0,1,0,1,#Div0,#Div0,#Div0
closed,0,0,1,1,2,#Div0,0.0,#Div0
reality,0,0,1,0,1,#Div0,#Div0,#Div0
shifts,0,0,1,0,1,#Div0,#Div0,#Div0
competition,0,0,0,1,1,#Div0,0.0,#Div0
foods,0,0,1,0,1,#Div0,#Div0,#Div0
done,0,0,10,0,10,#Div0,#Div0,#Div0
similar,0,0,1,0,1,#Div0,#Div0,#Div0
overtime,0,0,1,0,1,#Div0,#Div0,#Div0
driving,0,0,2,0,2,#Div0,#Div0,#Div0
masters,0,0,1,0,1,#Div0,#Div0,#Div0
span,0,0,1,0,1,#Div0,#Div0,#Div0
Marx,0,0,1,0,1,#Div0,#Div0,#Div0
prefers,0,0,1,0,1,#Div0,#Div0,#Div0
something,0,0,3,0,3,#Div0,#Div0,#Div0
go,0,15,42,8,65,0.0,0.0,#Div0
adapt,0,0,3,0,3,#Div0,#Div0,#Div0
fat,0,1,0,0,1,0.0,#Div0,#Div0
system,0,0,5,0,5,#Div0,#Div0,#Div0
overall,0,0,2,0,2,#Div0,#Div0,#Div0
becaue,0,0,1,0,1,#Div0,#Div0,#Div0
organizing,0,0,4,0,4,#Div0,#Div0,#Div0
Having,0,0,5,0,5,#Div0,#Div0,#Div0
bad,0,0,12,0,12,#Div0,#Div0,#Div0
lessons,0,0,2,0,2,#Div0,#Div0,#Div0
abig,0,0,1,0,1,#Div0,#Div0,#Div0
style,0,0,3,0,3,#Div0,#Div0,#Div0
guide,0,0,76,0,76,#Div0,#Div0,#Div0
suffering,0,0,2,1,3,#Div0,0.0,#Div0
discoverd,0,0,0,1,1,#Div0,0.0,#Div0
building,0,0,3,1,4,#Div0,0.0,#Div0
tested,0,0,1,0,1,#Div0,#Div0,#Div0
dozens,0,0,1,0,1,#Div0,#Div0,#Div0
challenging,0,0,8,2,10,#Div0,0.0,#Div0
relying,0,0,0,1,1,#Div0,0.0,#Div0
discovers,0,0,1,0,1,#Div0,#Div0,#Div0
example,0,2,6,0,8,0.0,#Div0,#Div0
acknowledging,0,0,1,0,1,#Div0,#Div0,#Div0
determined,0,0,1,0,1,#Div0,#Div0,#Div0
varieties,0,0,1,0,1,#Div0,#Div0,#Div0
wish,0,0,2,0,2,#Div0,#Div0,#Div0
twelve-hour,0,0,2,0,2,#Div0,#Div0,#Div0
electric,0,0,5,0,5,#Div0,#Div0,#Div0
specific,0,0,40,0,40,#Div0,#Div0,#Div0
stories,0,0,1,0,1,#Div0,#Div0,#Div0
gave,0,0,6,3,9,#Div0,0.0,#Div0
endure,0,0,0,1,1,#Div0,0.0,#Div0
Kong,0,0,1,0,1,#Div0,#Div0,#Div0
seing,0,0,1,0,1,#Div0,#Div0,#Div0
around,0,0,0,1,1,#Div0,0.0,#Div0
spikes,0,0,0,1,1,#Div0,0.0,#Div0
embed,0,0,0,1,1,#Div0,0.0,#Div0
distinguished,0,0,2,0,2,#Div0,#Div0,#Div0
infer,0,0,1,0,1,#Div0,#Div0,#Div0
apply,0,0,1,0,1,#Div0,#Div0,#Div0
cut,0,0,1,1,2,#Div0,0.0,#Div0
expensive,0,0,7,0,7,#Div0,#Div0,#Div0
white,0,0,1,0,1,#Div0,#Div0,#Div0
educational,0,0,4,0,4,#Div0,#Div0,#Div0
rice,0,0,1,0,1,#Div0,#Div0,#Div0
food,0,0,2,0,2,#Div0,#Div0,#Div0
controversial,0,0,1,0,1,#Div0,#Div0,#Div0
vanish,0,0,0,1,1,#Div0,0.0,#Div0
data,0,0,1,0,1,#Div0,#Div0,#Div0
major,0,0,7,0,7,#Div0,#Div0,#Div0
failed,0,0,2,0,2,#Div0,#Div0,#Div0
polluting,0,0,1,0,1,#Div0,#Div0,#Div0
John,0,0,1,0,1,#Div0,#Div0,#Div0
approach,0,0,0,1,1,#Div0,0.0,#Div0
global,0,0,7,0,7,#Div0,#Div0,#Div0
phase,0,0,0,1,1,#Div0,0.0,#Div0
quantneeded,0,0,1,0,1,#Div0,#Div0,#Div0
increases,0,0,1,1,2,#Div0,0.0,#Div0
occasions,0,0,1,0,1,#Div0,#Div0,#Div0
upcoming,0,0,1,0,1,#Div0,#Div0,#Div0
literatures,0,0,1,0,1,#Div0,#Div0,#Div0
helpful,0,0,1,0,1,#Div0,#Div0,#Div0
detail,0,0,1,0,1,#Div0,#Div0,#Div0
Revolution,0,0,1,0,1,#Div0,#Div0,#Div0
creates,0,0,2,0,2,#Div0,#Div0,#Div0
concerning,0,0,1,0,1,#Div0,#Div0,#Div0
decline,0,0,1,0,1,#Div0,#Div0,#Div0
offices,0,0,1,0,1,#Div0,#Div0,#Div0
commercial,0,0,2,0,2,#Div0,#Div0,#Div0
sizing,0,0,1,0,1,#Div0,#Div0,#Div0
pleasure,0,0,1,0,1,#Div0,#Div0,#Div0
classmate,0,0,1,0,1,#Div0,#Div0,#Div0
grand,0,0,2,0,2,#Div0,#Div0,#Div0
Specializing,0,0,3,0,3,#Div0,#Div0,#Div0
virtual,0,0,1,0,1,#Div0,#Div0,#Div0
false,0,0,3,1,4,#Div0,0.0,#Div0
Understanding,0,0,4,0,4,#Div0,#Div0,#Div0
athlete,0,0,1,0,1,#Div0,#Div0,#Div0
kept,0,0,1,1,2,#Div0,0.0,#Div0
searching,0,2,1,0,3,0.0,#Div0,#Div0
offers,0,0,2,0,2,#Div0,#Div0,#Div0
n,0,0,1,0,1,#Div0,#Div0,#Div0
rapid,0,0,1,0,1,#Div0,#Div0,#Div0
authentic,0,0,1,0,1,#Div0,#Div0,#Div0
went,0,3,10,0,13,0.0,#Div0,#Div0
studies,0,1,2,0,3,0.0,#Div0,#Div0
realted,0,0,1,0,1,#Div0,#Div0,#Div0
showing,0,0,7,0,7,#Div0,#Div0,#Div0
abandon,0,0,0,2,2,#Div0,0.0,#Div0
faculty,0,0,1,0,1,#Div0,#Div0,#Div0
free,0,0,2,15,17,#Div0,0.0,#Div0
actual,0,0,3,0,3,#Div0,#Div0,#Div0
thi,0,0,1,0,1,#Div0,#Div0,#Div0
medical,0,0,5,0,5,#Div0,#Div0,#Div0
compare,0,0,2,0,2,#Div0,#Div0,#Div0
send,0,0,0,1,1,#Div0,0.0,#Div0
dreamed,0,0,1,0,1,#Div0,#Div0,#Div0
places,0,0,6,1,7,#Div0,0.0,#Div0
early,0,0,4,1,5,#Div0,0.0,#Div0
respected,0,0,1,0,1,#Div0,#Div0,#Div0
aproach,0,0,0,2,2,#Div0,0.0,#Div0
used,0,0,27,0,27,#Div0,#Div0,#Div0
lived,0,0,5,0,5,#Div0,#Div0,#Div0
special,0,0,7,0,7,#Div0,#Div0,#Div0
practical,0,0,5,0,5,#Div0,#Div0,#Div0
perfect,0,0,1,0,1,#Div0,#Div0,#Div0
fight,1,0,0,2,3,1.0,0.3333333333333333,0.5
qualified,0,0,1,0,1,#Div0,#Div0,#Div0
argued,0,0,2,0,2,#Div0,#Div0,#Div0
heard,0,0,2,0,2,#Div0,#Div0,#Div0
trys,0,0,2,0,2,#Div0,#Div0,#Div0
rejected,0,0,1,1,2,#Div0,0.0,#Div0
came,0,0,6,0,6,#Div0,#Div0,#Div0
moment,0,0,1,0,1,#Div0,#Div0,#Div0
explains,0,0,3,0,3,#Div0,#Div0,#Div0
discovering,0,0,1,0,1,#Div0,#Div0,#Div0
thrilled,0,0,1,0,1,#Div0,#Div0,#Div0
Going,0,0,1,0,1,#Div0,#Div0,#Div0
view,0,0,1,1,2,#Div0,0.0,#Div0
environmental,0,0,4,0,4,#Div0,#Div0,#Div0
page,0,0,1,0,1,#Div0,#Div0,#Div0
advertised,0,0,3,0,3,#Div0,#Div0,#Div0
predict,0,0,1,0,1,#Div0,#Div0,#Div0
Cambodian,0,0,1,0,1,#Div0,#Div0,#Div0
loss,0,0,0,1,1,#Div0,0.0,#Div0
interact,0,0,3,1,4,#Div0,0.0,#Div0
causes,0,0,3,0,3,#Div0,#Div0,#Div0
channels,0,0,0,1,1,#Div0,0.0,#Div0
risky,0,0,8,0,8,#Div0,#Div0,#Div0
especialy,0,0,1,0,1,#Div0,#Div0,#Div0
attack,0,0,2,0,2,#Div0,#Div0,#Div0
dislike,0,0,3,0,3,#Div0,#Div0,#Div0
cultural,0,0,7,0,7,#Div0,#Div0,#Div0
mechanically,0,0,0,1,1,#Div0,0.0,#Div0
facilitations,0,0,1,0,1,#Div0,#Div0,#Div0
appreciating,0,0,1,0,1,#Div0,#Div0,#Div0
owing,0,0,1,0,1,#Div0,#Div0,#Div0
target,1,0,0,0,1,1.0,1.0,1.0
Attending,0,0,1,0,1,#Div0,#Div0,#Div0
challenge,0,0,1,1,2,#Div0,0.0,#Div0
single,0,0,7,0,7,#Div0,#Div0,#Div0
Sartori,0,0,1,0,1,#Div0,#Div0,#Div0
piece,0,0,0,1,1,#Div0,0.0,#Div0
enhancing,0,0,2,0,2,#Div0,#Div0,#Div0
magazines,0,0,1,0,1,#Div0,#Div0,#Div0
spoken,0,0,1,0,1,#Div0,#Div0,#Div0
valuable,0,0,2,0,2,#Div0,#Div0,#Div0
supplies,0,0,1,0,1,#Div0,#Div0,#Div0
ads,0,0,1,0,1,#Div0,#Div0,#Div0
grasp,1,0,0,0,1,1.0,1.0,1.0
includes,0,0,2,0,2,#Div0,#Div0,#Div0
basing,0,0,0,1,1,#Div0,0.0,#Div0
Doing,0,0,4,0,4,#Div0,#Div0,#Div0
harming,0,0,1,0,1,#Div0,#Div0,#Div0
said,0,0,25,0,25,#Div0,#Div0,#Div0
suggestion,0,0,1,0,1,#Div0,#Div0,#Div0
provided,0,0,9,0,9,#Div0,#Div0,#Div0
problems,0,0,8,0,8,#Div0,#Div0,#Div0
living,0,1,10,0,11,0.0,#Div0,#Div0
m,0,0,15,0,15,#Div0,#Div0,#Div0
rush,0,0,0,1,1,#Div0,0.0,#Div0
India,0,0,1,0,1,#Div0,#Div0,#Div0
steal,0,0,2,0,2,#Div0,#Div0,#Div0
lets,0,0,1,0,1,#Div0,#Div0,#Div0
understanding,0,0,29,0,29,#Div0,#Div0,#Div0
Chinese,0,0,1,0,1,#Div0,#Div0,#Div0
bound,0,0,0,2,2,#Div0,0.0,#Div0
little,0,0,16,1,17,#Div0,0.0,#Div0
area,0,0,0,2,2,#Div0,0.0,#Div0
search,0,2,2,1,5,0.0,0.0,#Div0
clean,0,0,2,0,2,#Div0,#Div0,#Div0
affective,0,0,1,0,1,#Div0,#Div0,#Div0
cites,0,0,1,0,1,#Div0,#Div0,#Div0
pay,0,0,5,6,11,#Div0,0.0,#Div0
teach,0,0,9,2,11,#Div0,0.0,#Div0
expose,0,0,2,0,2,#Div0,#Div0,#Div0
people,0,0,29,0,29,#Div0,#Div0,#Div0
looking,0,0,10,0,10,#Div0,#Div0,#Div0
challeng,0,1,0,0,1,0.0,#Div0,#Div0
familiar,0,0,0,1,1,#Div0,0.0,#Div0
strengthen,1,0,0,0,1,1.0,1.0,1.0
suport,0,0,0,1,1,#Div0,0.0,#Div0
gather,0,0,1,3,4,#Div0,0.0,#Div0
center,0,0,3,0,3,#Div0,#Div0,#Div0
principal,0,0,2,0,2,#Div0,#Div0,#Div0
Sharing,0,0,1,0,1,#Div0,#Div0,#Div0
keeps,0,0,2,0,2,#Div0,#Div0,#Div0
third,0,0,1,0,1,#Div0,#Div0,#Div0
permanent,0,0,1,0,1,#Div0,#Div0,#Div0
valid,0,0,1,0,1,#Div0,#Div0,#Div0
survival,0,0,1,0,1,#Div0,#Div0,#Div0
expressions,0,0,2,0,2,#Div0,#Div0,#Div0
exciting,0,0,2,0,2,#Div0,#Div0,#Div0
suffered,0,0,1,0,1,#Div0,#Div0,#Div0
circumstances,0,0,1,0,1,#Div0,#Div0,#Div0
trust,0,1,2,0,3,0.0,#Div0,#Div0
chinese,0,0,3,0,3,#Div0,#Div0,#Div0
box,0,1,0,0,1,0.0,#Div0,#Div0
dedicate,0,0,1,8,9,#Div0,0.0,#Div0
shift,0,0,0,2,2,#Div0,0.0,#Div0
remembers,0,0,1,0,1,#Div0,#Div0,#Div0
enables,0,0,1,0,1,#Div0,#Div0,#Div0
harm,0,0,1,2,3,#Div0,0.0,#Div0
settle,0,0,0,2,2,#Div0,0.0,#Div0
decrease,0,0,6,0,6,#Div0,#Div0,#Div0
's,0,0,44,0,44,#Div0,#Div0,#Div0
manager,0,0,1,0,1,#Div0,#Div0,#Div0
expressed,0,0,1,0,1,#Div0,#Div0,#Div0
manufacturers,0,0,1,0,1,#Div0,#Div0,#Div0
mainstream,0,0,0,1,1,#Div0,0.0,#Div0
know,0,0,81,0,81,#Div0,#Div0,#Div0
consume,2,0,2,0,4,1.0,1.0,1.0
Indian,0,0,1,0,1,#Div0,#Div0,#Div0
Long,0,0,1,0,1,#Div0,#Div0,#Div0
maximization,0,0,1,0,1,#Div0,#Div0,#Div0
concentrating,0,0,0,2,2,#Div0,0.0,#Div0
time,0,0,14,0,14,#Div0,#Div0,#Div0
shed,0,0,0,1,1,#Div0,0.0,#Div0
experiment,1,0,2,0,3,1.0,1.0,1.0
revolution,0,0,0,1,1,#Div0,0.0,#Div0
choose,0,0,18,0,18,#Div0,#Div0,#Div0
met,0,0,4,0,4,#Div0,#Div0,#Div0
busy,0,0,1,0,1,#Div0,#Div0,#Div0
associated,0,0,3,0,3,#Div0,#Div0,#Div0
discouraged,0,0,1,0,1,#Div0,#Div0,#Div0
investing,0,0,1,0,1,#Div0,#Div0,#Div0
washing,0,0,1,0,1,#Div0,#Div0,#Div0
attain,0,0,1,0,1,#Div0,#Div0,#Div0
core,0,0,0,1,1,#Div0,0.0,#Div0
consulted,0,0,1,0,1,#Div0,#Div0,#Div0
wishes,0,0,1,0,1,#Div0,#Div0,#Div0
begin,0,0,3,0,3,#Div0,#Div0,#Div0
limit,0,0,1,1,2,#Div0,0.0,#Div0
successfull,0,0,3,0,3,#Div0,#Div0,#Div0
underground,0,0,1,0,1,#Div0,#Div0,#Div0
entertain,0,0,1,0,1,#Div0,#Div0,#Div0
imagined,0,0,1,0,1,#Div0,#Div0,#Div0
sacrifice,0,0,0,1,1,#Div0,0.0,#Div0
development,0,0,5,0,5,#Div0,#Div0,#Div0
product,0,0,2,0,2,#Div0,#Div0,#Div0
exotic,0,0,0,1,1,#Div0,0.0,#Div0
associate,0,0,1,0,1,#Div0,#Div0,#Div0
argue,0,0,2,0,2,#Div0,#Div0,#Div0
expected,0,0,4,0,4,#Div0,#Div0,#Div0
strategics,0,0,1,0,1,#Div0,#Div0,#Div0
differs,0,0,1,0,1,#Div0,#Div0,#Div0
evaluate,0,0,1,0,1,#Div0,#Div0,#Div0
renounce,0,0,1,0,1,#Div0,#Div0,#Div0
relay,0,0,0,1,1,#Div0,0.0,#Div0
Do,0,0,1,0,1,#Div0,#Div0,#Div0
failure,0,0,1,0,1,#Div0,#Div0,#Div0
aware,0,0,1,0,1,#Div0,#Div0,#Div0
did,0,0,26,0,26,#Div0,#Div0,#Div0
does,0,0,39,0,39,#Div0,#Div0,#Div0
present,0,0,7,0,7,#Div0,#Div0,#Div0
attached,0,0,0,2,2,#Div0,0.0,#Div0
animal,0,0,1,0,1,#Div0,#Div0,#Div0
usage,0,1,1,0,2,0.0,#Div0,#Div0
parallel,0,0,0,1,1,#Div0,0.0,#Div0
symptoms,0,0,1,0,1,#Div0,#Div0,#Div0
appealing,0,0,0,1,1,#Div0,0.0,#Div0
italian,0,0,2,0,2,#Div0,#Div0,#Div0
fast,0,0,2,0,2,#Div0,#Div0,#Div0
reaching,1,0,0,5,6,1.0,0.16666666666666666,0.2857142857142857
online,0,0,1,0,1,#Div0,#Div0,#Div0
rent,0,0,1,0,1,#Div0,#Div0,#Div0
doesnot,0,0,1,0,1,#Div0,#Div0,#Div0
therefore,0,0,2,0,2,#Div0,#Div0,#Div0
passive,0,0,0,1,1,#Div0,0.0,#Div0
presence,0,0,2,0,2,#Div0,#Div0,#Div0
demand,0,0,1,0,1,#Div0,#Div0,#Div0
convincing,0,0,2,0,2,#Div0,#Div0,#Div0
pf,0,0,1,0,1,#Div0,#Div0,#Div0
inflate,0,0,0,1,1,#Div0,0.0,#Div0
appreciate,0,0,1,0,1,#Div0,#Div0,#Div0
differentiate,0,0,1,0,1,#Div0,#Div0,#Div0
introduce,0,0,2,0,2,#Div0,#Div0,#Div0
tolerating,0,0,0,1,1,#Div0,0.0,#Div0
intresting,0,0,2,0,2,#Div0,#Div0,#Div0
depend,0,0,4,0,4,#Div0,#Div0,#Div0
breaking,0,0,0,1,1,#Div0,0.0,#Div0
shattered,0,0,0,1,1,#Div0,0.0,#Div0
after,0,0,0,1,1,#Div0,0.0,#Div0
States,0,0,9,0,9,#Div0,#Div0,#Div0
summarize,0,0,3,0,3,#Div0,#Div0,#Div0
avoided,0,0,1,0,1,#Div0,#Div0,#Div0
kindness,0,0,1,0,1,#Div0,#Div0,#Div0
promote,0,0,3,1,4,#Div0,0.0,#Div0
gases,0,0,1,0,1,#Div0,#Div0,#Div0
central,0,0,1,0,1,#Div0,#Div0,#Div0
course,0,0,2,0,2,#Div0,#Div0,#Div0
standard,0,0,1,0,1,#Div0,#Div0,#Div0
inventing,0,0,1,0,1,#Div0,#Div0,#Div0
Know,0,0,2,0,2,#Div0,#Div0,#Div0
mind,0,0,3,0,3,#Div0,#Div0,#Div0
market,0,0,1,0,1,#Div0,#Div0,#Div0
Planning,0,0,1,0,1,#Div0,#Div0,#Div0
graduate,0,0,2,0,2,#Div0,#Div0,#Div0
ruining,0,0,0,5,5,#Div0,0.0,#Div0
shocking,0,0,0,2,2,#Div0,0.0,#Div0
ruin,0,0,0,1,1,#Div0,0.0,#Div0
situation,0,0,5,0,5,#Div0,#Div0,#Div0
put,0,0,2,6,8,#Div0,0.0,#Div0
seeking,0,0,1,0,1,#Div0,#Div0,#Div0
thorough,0,0,1,0,1,#Div0,#Div0,#Div0
relied,0,0,0,1,1,#Div0,0.0,#Div0
deliver,0,0,0,1,1,#Div0,0.0,#Div0
mentioned,0,0,13,0,13,#Div0,#Div0,#Div0
calculate,0,0,1,1,2,#Div0,0.0,#Div0
rainy,0,0,1,0,1,#Div0,#Div0,#Div0
worths,0,0,2,0,2,#Div0,#Div0,#Div0
extent,0,0,1,0,1,#Div0,#Div0,#Div0
choosen,0,0,1,0,1,#Div0,#Div0,#Div0
surprised,0,0,2,0,2,#Div0,#Div0,#Div0
leading,0,0,2,1,3,#Div0,0.0,#Div0
approving,0,0,1,0,1,#Div0,#Div0,#Div0
matured,0,0,1,0,1,#Div0,#Div0,#Div0
attact,0,0,0,1,1,#Div0,0.0,#Div0
need,0,0,62,1,63,#Div0,0.0,#Div0
egyptians,0,0,1,0,1,#Div0,#Div0,#Div0
complicated,0,0,5,0,5,#Div0,#Div0,#Div0
ourself,0,0,1,0,1,#Div0,#Div0,#Div0
evolved,0,0,0,2,2,#Div0,0.0,#Div0
humans,0,0,1,0,1,#Div0,#Div0,#Div0
indicates,0,0,1,0,1,#Div0,#Div0,#Div0
tase,0,0,0,1,1,#Div0,0.0,#Div0
production,0,0,1,0,1,#Div0,#Div0,#Div0
societies,0,0,1,0,1,#Div0,#Div0,#Div0
sign,0,0,0,1,1,#Div0,0.0,#Div0
customers,0,1,1,0,2,0.0,#Div0,#Div0
grasping,1,0,0,0,1,1.0,1.0,1.0
persuing,0,0,0,1,1,#Div0,0.0,#Div0
Take,0,0,2,0,2,#Div0,#Div0,#Div0
fixed,0,0,0,1,1,#Div0,0.0,#Div0
civil,0,0,2,0,2,#Div0,#Div0,#Div0
years,0,0,8,0,8,#Div0,#Div0,#Div0
happened,0,0,9,0,9,#Div0,#Div0,#Div0
community,0,0,3,0,3,#Div0,#Div0,#Div0
spray,0,0,1,0,1,#Div0,#Div0,#Div0
rest,0,1,4,0,5,0.0,#Div0,#Div0
self-pleasing,0,0,2,0,2,#Div0,#Div0,#Div0
lisence,0,0,1,0,1,#Div0,#Div0,#Div0
friend,0,0,2,0,2,#Div0,#Div0,#Div0
depicted,0,0,0,1,1,#Div0,0.0,#Div0
golfing,0,0,1,0,1,#Div0,#Div0,#Div0
citizens,0,0,1,0,1,#Div0,#Div0,#Div0
true,0,0,5,0,5,#Div0,#Div0,#Div0
marketing,0,0,1,0,1,#Div0,#Div0,#Div0
potential,0,0,1,0,1,#Div0,#Div0,#Div0
schools,0,0,1,0,1,#Div0,#Div0,#Div0
array,0,0,0,2,2,#Div0,0.0,#Div0
recognize,0,0,1,0,1,#Div0,#Div0,#Div0
kings,0,0,0,1,1,#Div0,0.0,#Div0
men,0,0,2,0,2,#Div0,#Div0,#Div0
been,0,0,32,0,32,#Div0,#Div0,#Div0
field,0,0,6,0,6,#Div0,#Div0,#Div0
classroom,0,0,1,0,1,#Div0,#Div0,#Div0
whit,0,0,1,0,1,#Div0,#Div0,#Div0
lack,0,0,2,2,4,#Div0,0.0,#Div0
deceiving,0,0,1,0,1,#Div0,#Div0,#Div0
check,0,0,1,0,1,#Div0,#Div0,#Div0
primary,0,0,4,0,4,#Div0,#Div0,#Div0
habit,0,1,0,0,1,0.0,#Div0,#Div0
job,0,0,1,0,1,#Div0,#Div0,#Div0
long-distance,0,0,1,0,1,#Div0,#Div0,#Div0
followed,0,0,2,1,3,#Div0,0.0,#Div0
prescribe,0,0,1,0,1,#Div0,#Div0,#Div0
immigrated,0,0,1,0,1,#Div0,#Div0,#Div0
earned,0,0,0,2,2,#Div0,0.0,#Div0
affordable,0,0,1,0,1,#Div0,#Div0,#Div0
trade,0,0,1,0,1,#Div0,#Div0,#Div0
village,0,0,0,1,1,#Div0,0.0,#Div0
concentrated,0,0,0,1,1,#Div0,0.0,#Div0
avalible,0,0,0,1,1,#Div0,0.0,#Div0
permit,0,0,1,0,1,#Div0,#Div0,#Div0
scenes,0,0,1,0,1,#Div0,#Div0,#Div0
set,0,0,2,0,2,#Div0,#Div0,#Div0
wast,0,0,0,1,1,#Div0,0.0,#Div0
sound,0,0,2,0,2,#Div0,#Div0,#Div0
faced,0,0,0,1,1,#Div0,0.0,#Div0
scratching,0,0,1,0,1,#Div0,#Div0,#Div0
incredible,0,0,3,0,3,#Div0,#Div0,#Div0
swiming,0,0,1,0,1,#Div0,#Div0,#Div0
Let,0,0,1,0,1,#Div0,#Div0,#Div0
old,0,0,31,0,31,#Div0,#Div0,#Div0
fail,0,0,2,0,2,#Div0,#Div0,#Div0
deal,0,0,1,1,2,#Div0,0.0,#Div0
circulating,0,0,2,0,2,#Div0,#Div0,#Div0
releasing,0,0,1,0,1,#Div0,#Div0,#Div0
claims,0,0,1,0,1,#Div0,#Div0,#Div0
souls,0,0,1,0,1,#Div0,#Div0,#Div0
communicated,0,0,1,0,1,#Div0,#Div0,#Div0
Meeting,0,0,1,0,1,#Div0,#Div0,#Div0
depending,0,0,5,0,5,#Div0,#Div0,#Div0
fifty,0,0,2,0,2,#Div0,#Div0,#Div0
appears,0,0,1,0,1,#Div0,#Div0,#Div0
communities,0,0,2,0,2,#Div0,#Div0,#Div0
own,0,0,46,1,47,#Div0,0.0,#Div0
remain,0,0,2,2,4,#Div0,0.0,#Div0
company,0,0,5,0,5,#Div0,#Div0,#Div0
intend,0,0,3,0,3,#Div0,#Div0,#Div0
proposed,0,0,2,0,2,#Div0,#Div0,#Div0
funny,0,0,1,0,1,#Div0,#Div0,#Div0
upper,0,0,1,0,1,#Div0,#Div0,#Div0
surprising,0,0,1,0,1,#Div0,#Div0,#Div0
ideal,0,0,1,0,1,#Div0,#Div0,#Div0
resources,0,0,1,0,1,#Div0,#Div0,#Div0
wars,0,0,1,0,1,#Div0,#Div0,#Div0
running,1,2,0,1,4,0.3333333333333333,0.5,0.4
established,0,0,3,3,6,#Div0,0.0,#Div0
loads,0,0,1,0,1,#Div0,#Div0,#Div0
assigned,0,0,1,0,1,#Div0,#Div0,#Div0
produced,0,0,1,0,1,#Div0,#Div0,#Div0
fits,0,0,0,1,1,#Div0,0.0,#Div0
constraints,0,0,0,1,1,#Div0,0.0,#Div0
beleive,0,0,4,0,4,#Div0,#Div0,#Div0
Finaly,0,0,1,0,1,#Div0,#Div0,#Div0
drives,0,0,1,0,1,#Div0,#Div0,#Div0
contemporary,0,0,3,0,3,#Div0,#Div0,#Div0
into,0,0,0,2,2,#Div0,0.0,#Div0
made,0,0,27,1,28,#Div0,0.0,#Div0
ride,0,1,1,0,2,0.0,#Div0,#Div0
built,0,0,2,4,6,#Div0,0.0,#Div0
social,0,0,18,0,18,#Div0,#Div0,#Div0
intersting,0,0,1,0,1,#Div0,#Div0,#Div0
percent,0,0,0,1,1,#Div0,0.0,#Div0
feels,0,0,2,0,2,#Div0,#Div0,#Div0
costs,0,0,1,0,1,#Div0,#Div0,#Div0
destroying,1,1,0,0,2,0.5,1.0,0.6666666666666666
understand,0,0,77,0,77,#Div0,#Div0,#Div0
trap,0,0,0,1,1,#Div0,0.0,#Div0
providing,0,0,0,1,1,#Div0,0.0,#Div0
microsoft,0,0,1,0,1,#Div0,#Div0,#Div0
rising,0,0,0,1,1,#Div0,0.0,#Div0
Successful,0,0,3,0,3,#Div0,#Div0,#Div0
responsible,0,0,2,0,2,#Div0,#Div0,#Div0
lying,0,0,1,0,1,#Div0,#Div0,#Div0
better,0,0,4,0,4,#Div0,#Div0,#Div0
prefer,0,0,23,0,23,#Div0,#Div0,#Div0
comming,0,0,1,0,1,#Div0,#Div0,#Div0
career,0,0,2,0,2,#Div0,#Div0,#Div0
ruled,0,0,1,0,1,#Div0,#Div0,#Div0
activities,0,0,3,0,3,#Div0,#Div0,#Div0
doing,0,0,25,0,25,#Div0,#Div0,#Div0
advancement,0,0,0,1,1,#Div0,0.0,#Div0
research,0,0,2,0,2,#Div0,#Div0,#Div0
golden,0,0,0,2,2,#Div0,0.0,#Div0
countries,0,0,1,0,1,#Div0,#Div0,#Div0
guess,0,0,4,0,4,#Div0,#Div0,#Div0
owner,0,0,2,0,2,#Div0,#Div0,#Div0
learned,0,0,15,0,15,#Div0,#Div0,#Div0
doesn,0,0,3,0,3,#Div0,#Div0,#Div0
different,0,0,69,0,69,#Div0,#Div0,#Div0
nowadays,0,0,13,0,13,#Div0,#Div0,#Div0
fun,0,0,4,0,4,#Div0,#Div0,#Div0
public,0,0,18,0,18,#Div0,#Div0,#Div0
checked,0,0,1,0,1,#Div0,#Div0,#Div0
confused,0,0,2,0,2,#Div0,#Div0,#Div0
seamen,0,0,1,0,1,#Div0,#Div0,#Div0
prove,0,0,4,0,4,#Div0,#Div0,#Div0
teaching,0,0,7,0,7,#Div0,#Div0,#Div0
everyday,0,0,12,0,12,#Div0,#Div0,#Div0
passes,0,0,1,0,1,#Div0,#Div0,#Div0
remains,0,0,2,0,2,#Div0,#Div0,#Div0
devoting,0,0,0,2,2,#Div0,0.0,#Div0
big,0,0,27,6,33,#Div0,0.0,#Div0
Examples,0,0,3,0,3,#Div0,#Div0,#Div0
responsibilities,0,0,1,0,1,#Div0,#Div0,#Div0
biased,0,0,1,0,1,#Div0,#Div0,#Div0
inhabiting,0,0,1,0,1,#Div0,#Div0,#Div0
glass-making,0,0,1,0,1,#Div0,#Div0,#Div0
find,0,0,42,7,49,#Div0,0.0,#Div0
relevant,0,0,1,0,1,#Div0,#Div0,#Div0
amazing,0,0,1,0,1,#Div0,#Div0,#Div0
realized,0,0,4,0,4,#Div0,#Div0,#Div0
theit,0,0,1,0,1,#Div0,#Div0,#Div0
attending,0,0,4,0,4,#Div0,#Div0,#Div0
aspect,0,0,5,1,6,#Div0,0.0,#Div0
involve,0,0,2,0,2,#Div0,#Div0,#Div0
air,0,0,1,0,1,#Div0,#Div0,#Div0
range,0,0,8,1,9,#Div0,0.0,#Div0
judging,0,0,0,1,1,#Div0,0.0,#Div0
sociological,0,0,1,0,1,#Div0,#Div0,#Div0
ony,0,0,1,0,1,#Div0,#Div0,#Div0
analyze,0,1,2,0,3,0.0,#Div0,#Div0
knowing,0,0,11,0,11,#Div0,#Div0,#Div0
studing,0,0,7,0,7,#Div0,#Div0,#Div0
pursuing,0,0,0,1,1,#Div0,0.0,#Div0
traveled,0,0,2,0,2,#Div0,#Div0,#Div0
knowledge,0,0,49,0,49,#Div0,#Div0,#Div0
speaks,0,0,1,0,1,#Div0,#Div0,#Div0
happend,0,0,2,0,2,#Div0,#Div0,#Div0
handling,0,0,0,2,2,#Div0,0.0,#Div0
from,0,0,0,2,2,#Div0,0.0,#Div0
using,0,0,27,1,28,#Div0,0.0,#Div0
sell,0,0,5,0,5,#Div0,#Div0,#Div0
american,0,0,1,0,1,#Div0,#Div0,#Div0
challenged,0,0,1,0,1,#Div0,#Div0,#Div0
proper,0,0,2,0,2,#Div0,#Div0,#Div0
complexities,0,0,0,1,1,#Div0,0.0,#Div0
taking,0,0,22,7,29,#Div0,0.0,#Div0
becuse,0,0,1,0,1,#Div0,#Div0,#Div0
speaking,0,0,3,0,3,#Div0,#Div0,#Div0
room,0,0,1,0,1,#Div0,#Div0,#Div0
aspects,0,0,2,0,2,#Div0,#Div0,#Div0
desired,0,0,1,0,1,#Div0,#Div0,#Div0
characterize,0,0,1,0,1,#Div0,#Div0,#Div0
played,0,1,0,0,1,0.0,#Div0,#Div0
affirming,0,0,1,0,1,#Div0,#Div0,#Div0
frustrated,0,0,1,0,1,#Div0,#Div0,#Div0
pull,0,0,0,1,1,#Div0,0.0,#Div0
semester,0,0,0,2,2,#Div0,0.0,#Div0
cause,0,0,14,0,14,#Div0,#Div0,#Div0
Tokyo,0,0,1,0,1,#Div0,#Div0,#Div0
took,0,0,12,0,12,#Div0,#Div0,#Div0
admit,0,0,1,0,1,#Div0,#Div0,#Div0
programms,0,0,1,0,1,#Div0,#Div0,#Div0
led,0,0,27,1,28,#Div0,0.0,#Div0
with-with,0,0,1,0,1,#Div0,#Div0,#Div0
obliged,0,0,1,0,1,#Div0,#Div0,#Div0
large,0,0,5,0,5,#Div0,#Div0,#Div0
Think,0,0,2,0,2,#Div0,#Div0,#Div0
policy,0,0,1,0,1,#Div0,#Div0,#Div0
work,0,4,30,2,36,0.0,0.0,#Div0
include,0,0,1,0,1,#Div0,#Div0,#Div0
pepole,0,0,1,0,1,#Div0,#Div0,#Div0
select,0,0,2,0,2,#Div0,#Div0,#Div0
caused,0,0,3,0,3,#Div0,#Div0,#Div0
purposes,0,0,1,0,1,#Div0,#Div0,#Div0
supported,0,0,1,7,8,#Div0,0.0,#Div0
visiting,0,0,10,0,10,#Div0,#Div0,#Div0
inferred,0,0,2,0,2,#Div0,#Div0,#Div0
none,0,0,1,0,1,#Div0,#Div0,#Div0
beatiful,0,0,0,1,1,#Div0,0.0,#Div0
changes,0,0,1,0,1,#Div0,#Div0,#Div0
allowing,0,0,1,0,1,#Div0,#Div0,#Div0
cover,0,0,1,2,3,#Div0,0.0,#Div0
understood,0,0,2,0,2,#Div0,#Div0,#Div0
welcomed,0,0,1,0,1,#Div0,#Div0,#Div0
implying,0,0,2,0,2,#Div0,#Div0,#Div0
increase,0,0,19,3,22,#Div0,0.0,#Div0
surround,0,0,0,1,1,#Div0,0.0,#Div0
explorer,0,0,1,0,1,#Div0,#Div0,#Div0
mass,0,0,1,0,1,#Div0,#Div0,#Div0
owners,0,0,1,0,1,#Div0,#Div0,#Div0
gaining,0,0,1,2,3,#Div0,0.0,#Div0
diffrent,0,0,4,0,4,#Div0,#Div0,#Div0
programs,0,0,4,0,4,#Div0,#Div0,#Div0
characterizes,0,0,1,0,1,#Div0,#Div0,#Div0
isolate,0,0,0,1,1,#Div0,0.0,#Div0
event,0,0,1,0,1,#Div0,#Div0,#Div0
small,0,0,11,3,14,#Div0,0.0,#Div0
jobs,0,0,4,0,4,#Div0,#Div0,#Div0
safety,0,0,1,0,1,#Div0,#Div0,#Div0
sailing,0,0,2,0,2,#Div0,#Div0,#Div0
discovery,0,0,1,1,2,#Div0,0.0,#Div0
untrue,0,0,1,0,1,#Div0,#Div0,#Div0
saved,0,0,1,1,2,#Div0,0.0,#Div0
choise,0,0,1,0,1,#Div0,#Div0,#Div0
sort,0,0,3,0,3,#Div0,#Div0,#Div0
poor,0,0,8,0,8,#Div0,#Div0,#Div0
wheel,0,0,0,2,2,#Div0,0.0,#Div0
cane,0,0,1,0,1,#Div0,#Div0,#Div0
limits,0,0,1,2,3,#Div0,0.0,#Div0
soft,0,0,0,1,1,#Div0,0.0,#Div0
reflects,0,0,0,1,1,#Div0,0.0,#Div0
refines,0,0,0,1,1,#Div0,0.0,#Div0
touch,0,0,0,1,1,#Div0,0.0,#Div0
observe,0,0,2,0,2,#Div0,#Div0,#Div0
sent,0,0,1,0,1,#Div0,#Div0,#Div0
laugh,0,0,1,0,1,#Div0,#Div0,#Div0
thanks,0,0,1,0,1,#Div0,#Div0,#Div0
viceversa,0,0,1,0,1,#Div0,#Div0,#Div0
eary,0,0,1,0,1,#Div0,#Div0,#Div0
appreciation,0,0,1,0,1,#Div0,#Div0,#Div0
memories,0,0,1,0,1,#Div0,#Div0,#Div0
assured,0,0,1,0,1,#Div0,#Div0,#Div0
allow,0,0,7,0,7,#Div0,#Div0,#Div0
reliable,0,0,2,0,2,#Div0,#Div0,#Div0
sure,0,0,1,0,1,#Div0,#Div0,#Div0
help,0,0,93,1,94,#Div0,0.0,#Div0
laziness,0,0,1,0,1,#Div0,#Div0,#Div0
created,0,0,2,0,2,#Div0,#Div0,#Div0
part,0,0,14,11,25,#Div0,0.0,#Div0
abscence,0,0,1,0,1,#Div0,#Div0,#Div0
spent,0,0,1,3,4,#Div0,0.0,#Div0
choosing,0,0,2,0,2,#Div0,#Div0,#Div0
scared,0,0,1,0,1,#Div0,#Div0,#Div0
founding,0,0,1,0,1,#Div0,#Div0,#Div0
builds,0,0,0,2,2,#Div0,0.0,#Div0
values,0,0,1,0,1,#Div0,#Div0,#Div0
difficulties,0,0,1,0,1,#Div0,#Div0,#Div0
hate,0,0,3,0,3,#Div0,#Div0,#Div0
process,0,0,5,0,5,#Div0,#Div0,#Div0
overestimate,0,0,1,0,1,#Div0,#Div0,#Div0
cleary,0,0,0,1,1,#Div0,0.0,#Div0
seemed,0,0,3,0,3,#Div0,#Div0,#Div0
satisfy,0,0,2,0,2,#Div0,#Div0,#Div0
Arabia,0,0,2,0,2,#Div0,#Div0,#Div0
industrial,0,0,2,0,2,#Div0,#Div0,#Div0
quite,0,0,1,0,1,#Div0,#Div0,#Div0
irresponsible,0,0,1,0,1,#Div0,#Div0,#Div0
car,0,0,2,0,2,#Div0,#Div0,#Div0
attributed,0,0,1,0,1,#Div0,#Div0,#Div0
terms,0,0,1,0,1,#Div0,#Div0,#Div0
demonstrate,0,0,1,0,1,#Div0,#Div0,#Div0
brag,0,0,1,0,1,#Div0,#Div0,#Div0
gets,0,0,4,1,5,#Div0,0.0,#Div0
student,0,0,3,0,3,#Div0,#Div0,#Div0
models,0,0,1,0,1,#Div0,#Div0,#Div0
channel,0,0,1,0,1,#Div0,#Div0,#Div0
meaningful,0,0,1,0,1,#Div0,#Div0,#Div0
equal,0,0,2,0,2,#Div0,#Div0,#Div0
nice,0,0,6,0,6,#Div0,#Div0,#Div0
background,0,0,2,1,3,#Div0,0.0,#Div0
pill,0,0,1,0,1,#Div0,#Div0,#Div0
radical,0,0,3,0,3,#Div0,#Div0,#Div0
meet,0,0,11,3,14,#Div0,0.0,#Div0
problem,0,0,9,0,9,#Div0,#Div0,#Div0
emphasis,0,0,1,0,1,#Div0,#Div0,#Div0
attracted,0,0,0,1,1,#Div0,0.0,#Div0
quit,0,0,2,0,2,#Div0,#Div0,#Div0
restore,0,0,1,0,1,#Div0,#Div0,#Div0
criticisms,0,0,1,0,1,#Div0,#Div0,#Div0
w,0,0,2,0,2,#Div0,#Div0,#Div0
personal,0,0,31,0,31,#Div0,#Div0,#Div0
designed,0,0,2,0,2,#Div0,#Div0,#Div0
protect,0,1,0,1,2,0.0,0.0,#Div0
whenever,0,0,1,0,1,#Div0,#Div0,#Div0
senior,0,1,1,0,2,0.0,#Div0,#Div0
realizes,0,0,1,0,1,#Div0,#Div0,#Div0
undermine,0,0,1,1,2,#Div0,0.0,#Div0
offered,0,0,1,0,1,#Div0,#Div0,#Div0
purchase,0,0,3,0,3,#Div0,#Div0,#Div0
say,0,0,56,0,56,#Div0,#Div0,#Div0
exist,0,0,3,0,3,#Div0,#Div0,#Div0
rendering,0,0,1,0,1,#Div0,#Div0,#Div0
load,0,0,0,2,2,#Div0,0.0,#Div0
evry,0,0,2,0,2,#Div0,#Div0,#Div0
Apart,0,0,1,0,1,#Div0,#Div0,#Div0
succeeded,0,0,3,0,3,#Div0,#Div0,#Div0
education,0,1,2,0,3,0.0,#Div0,#Div0
mundane,0,0,1,0,1,#Div0,#Div0,#Div0
supports,0,0,1,2,3,#Div0,0.0,#Div0
vast,0,0,2,2,4,#Div0,0.0,#Div0
practicable,0,0,1,0,1,#Div0,#Div0,#Div0
recent,0,0,1,0,1,#Div0,#Div0,#Div0
calm,0,0,0,1,1,#Div0,0.0,#Div0
relate,0,0,1,0,1,#Div0,#Div0,#Div0
afford,0,0,3,0,3,#Div0,#Div0,#Div0
was,0,0,97,0,97,#Div0,#Div0,#Div0
durring,0,0,1,0,1,#Div0,#Div0,#Div0
starts,0,0,2,0,2,#Div0,#Div0,#Div0
producers,0,0,1,0,1,#Div0,#Div0,#Div0
administration,0,0,1,0,1,#Div0,#Div0,#Div0
lower,0,0,1,0,1,#Div0,#Div0,#Div0
majority,0,0,0,1,1,#Div0,0.0,#Div0
products,0,2,4,0,6,0.0,#Div0,#Div0
trip,0,0,3,0,3,#Div0,#Div0,#Div0
contributing,0,0,0,1,1,#Div0,0.0,#Div0
pampered,0,0,0,2,2,#Div0,0.0,#Div0
were,0,0,32,0,32,#Div0,#Div0,#Div0
fake,0,0,0,1,1,#Div0,0.0,#Div0
covers,0,0,0,1,1,#Div0,0.0,#Div0
passed,0,0,0,1,1,#Div0,0.0,#Div0
Learning,0,0,2,0,2,#Div0,#Div0,#Div0
believing,0,0,1,0,1,#Div0,#Div0,#Div0
encounter,0,0,1,1,2,#Div0,0.0,#Div0
lovely,0,0,1,0,1,#Div0,#Div0,#Div0
buying,0,0,13,0,13,#Div0,#Div0,#Div0
dreaming,0,0,0,1,1,#Div0,0.0,#Div0
plannning,0,0,1,0,1,#Div0,#Div0,#Div0
capacity,0,0,1,0,1,#Div0,#Div0,#Div0
invest,0,0,2,1,3,#Div0,0.0,#Div0
focused,0,0,0,5,5,#Div0,0.0,#Div0
support,0,0,6,11,17,#Div0,0.0,#Div0
satisfying,0,0,2,0,2,#Div0,#Div0,#Div0
demands,0,0,1,0,1,#Div0,#Div0,#Div0
conduce,0,0,0,1,1,#Div0,0.0,#Div0
loses,0,0,0,1,1,#Div0,0.0,#Div0
translate,0,0,1,0,1,#Div0,#Div0,#Div0
useing,0,0,2,0,2,#Div0,#Div0,#Div0
Japanese,0,0,8,0,8,#Div0,#Div0,#Div0
incorrect,0,0,0,1,1,#Div0,0.0,#Div0
telling,0,0,1,1,2,#Div0,0.0,#Div0
considered,0,0,11,0,11,#Div0,#Div0,#Div0
circle,0,0,0,1,1,#Div0,0.0,#Div0
drive,0,0,4,1,5,#Div0,0.0,#Div0
comforatable,0,0,0,1,1,#Div0,0.0,#Div0
sides,0,0,0,1,1,#Div0,0.0,#Div0
disciplines,0,0,1,0,1,#Div0,#Div0,#Div0
Few,0,0,1,0,1,#Div0,#Div0,#Div0
needs,0,0,12,0,12,#Div0,#Div0,#Div0
attract,2,0,0,4,6,1.0,0.3333333333333333,0.5
phases,0,0,0,1,1,#Div0,0.0,#Div0
concern,0,0,1,0,1,#Div0,#Div0,#Div0
impressions,0,0,1,0,1,#Div0,#Div0,#Div0
causing,0,0,1,0,1,#Div0,#Div0,#Div0
important,0,0,36,0,36,#Div0,#Div0,#Div0
Concluding,0,0,1,0,1,#Div0,#Div0,#Div0
of,0,0,0,4,4,#Div0,0.0,#Div0
statistical,0,0,1,0,1,#Div0,#Div0,#Div0
number,0,0,48,0,48,#Div0,#Div0,#Div0
became,0,0,3,0,3,#Div0,#Div0,#Div0
chain,0,0,0,2,2,#Div0,0.0,#Div0
written,0,0,5,0,5,#Div0,#Div0,#Div0
enough,0,0,35,0,35,#Div0,#Div0,#Div0
Taking,0,0,1,1,2,#Div0,0.0,#Div0
woman,0,0,1,0,1,#Div0,#Div0,#Div0
dress,0,0,1,0,1,#Div0,#Div0,#Div0
routine,0,0,1,0,1,#Div0,#Div0,#Div0
instruments,0,0,0,1,1,#Div0,0.0,#Div0
drastic,0,0,1,0,1,#Div0,#Div0,#Div0
mastered,0,0,1,0,1,#Div0,#Div0,#Div0
probaly,0,0,1,0,1,#Div0,#Div0,#Div0
good,0,0,75,0,75,#Div0,#Div0,#Div0
international,0,0,1,0,1,#Div0,#Div0,#Div0
roam,0,0,0,1,1,#Div0,0.0,#Div0
shrink,0,0,0,1,1,#Div0,0.0,#Div0
charing,0,0,1,0,1,#Div0,#Div0,#Div0
Analyzing,0,0,1,0,1,#Div0,#Div0,#Div0
konw,0,0,1,0,1,#Div0,#Div0,#Div0
stick,1,0,0,1,2,1.0,0.5,0.6666666666666666
illiterate,0,0,1,0,1,#Div0,#Div0,#Div0
sensation,0,0,1,0,1,#Div0,#Div0,#Div0
die,0,0,1,0,1,#Div0,#Div0,#Div0
beeing,0,0,1,0,1,#Div0,#Div0,#Div0
climb,0,0,1,1,2,#Div0,0.0,#Div0
disagree,0,0,46,0,46,#Div0,#Div0,#Div0
paving,0,0,0,2,2,#Div0,0.0,#Div0
Changing,0,0,1,0,1,#Div0,#Div0,#Div0
part-time,0,0,1,0,1,#Div0,#Div0,#Div0
near,0,0,1,0,1,#Div0,#Div0,#Div0
conducted,0,0,1,0,1,#Div0,#Div0,#Div0
tend,0,0,11,0,11,#Div0,#Div0,#Div0
loosing,0,0,0,1,1,#Div0,0.0,#Div0
concentrate,0,0,1,1,2,#Div0,0.0,#Div0
advertisements,0,0,2,0,2,#Div0,#Div0,#Div0
blend,0,0,0,1,1,#Div0,0.0,#Div0
throwing,0,0,0,1,1,#Div0,0.0,#Div0
proved,0,0,3,0,3,#Div0,#Div0,#Div0
communicate,0,0,12,0,12,#Div0,#Div0,#Div0
biological,0,0,2,0,2,#Div0,#Div0,#Div0
scratch,0,0,0,1,1,#Div0,0.0,#Div0
individual,0,0,4,0,4,#Div0,#Div0,#Div0
throught,0,0,2,0,2,#Div0,#Div0,#Div0
felt,0,0,5,1,6,#Div0,0.0,#Div0
chosen,0,0,2,0,2,#Div0,#Div0,#Div0
Sabay,0,0,2,0,2,#Div0,#Div0,#Div0
relative,0,0,2,0,2,#Div0,#Div0,#Div0
summary,0,0,1,0,1,#Div0,#Div0,#Div0
ability,0,0,2,0,2,#Div0,#Div0,#Div0
included,0,0,1,0,1,#Div0,#Div0,#Div0
loose,0,0,1,2,3,#Div0,0.0,#Div0
horse,0,0,1,0,1,#Div0,#Div0,#Div0
location,0,0,1,0,1,#Div0,#Div0,#Div0
looks,0,0,2,0,2,#Div0,#Div0,#Div0
suspecting,0,0,1,0,1,#Div0,#Div0,#Div0
deriving,0,0,0,2,2,#Div0,0.0,#Div0
bussiness,0,0,1,0,1,#Div0,#Div0,#Div0
rate,0,0,3,0,3,#Div0,#Div0,#Div0
correct,0,0,1,0,1,#Div0,#Div0,#Div0
inter,0,0,3,0,3,#Div0,#Div0,#Div0
desires,0,0,1,0,1,#Div0,#Div0,#Div0
tendency,0,0,1,0,1,#Div0,#Div0,#Div0
crash,0,0,0,1,1,#Div0,0.0,#Div0
Big,0,0,1,0,1,#Div0,#Div0,#Div0
characters,0,0,1,0,1,#Div0,#Div0,#Div0
parking,0,0,2,0,2,#Div0,#Div0,#Div0
person,0,0,6,0,6,#Div0,#Div0,#Div0
elderly,0,1,0,0,1,0.0,#Div0,#Div0
potencial,0,0,1,0,1,#Div0,#Div0,#Div0
struggle,0,0,0,1,1,#Div0,0.0,#Div0
answering,0,0,1,0,1,#Div0,#Div0,#Div0
dissappointed,0,0,1,0,1,#Div0,#Div0,#Div0
portable,0,0,1,0,1,#Div0,#Div0,#Div0
guides,0,0,2,0,2,#Div0,#Div0,#Div0
the,0,0,0,4,4,#Div0,0.0,#Div0
experiences,0,0,2,0,2,#Div0,#Div0,#Div0
easy,0,0,4,1,5,#Div0,0.0,#Div0
becuase,0,0,1,0,1,#Div0,#Div0,#Div0
hiding,0,0,0,2,2,#Div0,0.0,#Div0
aging,0,0,2,0,2,#Div0,#Div0,#Div0
fanatic,0,0,0,1,1,#Div0,0.0,#Div0
jordan,0,0,1,0,1,#Div0,#Div0,#Div0
aquiring,0,0,1,0,1,#Div0,#Div0,#Div0
Educational,0,0,1,0,1,#Div0,#Div0,#Div0
avoid,0,0,7,1,8,#Div0,0.0,#Div0
visited,0,0,6,0,6,#Div0,#Div0,#Div0
observing,0,0,1,0,1,#Div0,#Div0,#Div0
middle,0,0,2,1,3,#Div0,0.0,#Div0
underlining,0,0,0,1,1,#Div0,0.0,#Div0
reach,1,0,0,13,14,1.0,0.07142857142857142,0.13333333333333333
dont,0,0,13,0,13,#Div0,#Div0,#Div0
population,0,0,3,1,4,#Div0,0.0,#Div0
recruit,0,0,2,0,2,#Div0,#Div0,#Div0
positive,0,0,5,0,5,#Div0,#Div0,#Div0
psychological,0,0,1,0,1,#Div0,#Div0,#Div0
pop,0,0,0,1,1,#Div0,0.0,#Div0
struggling,0,0,0,1,1,#Div0,0.0,#Div0
hours,0,0,2,0,2,#Div0,#Div0,#Div0
entertains,0,0,1,0,1,#Div0,#Div0,#Div0
junior,0,0,1,0,1,#Div0,#Div0,#Div0
life,0,0,11,0,11,#Div0,#Div0,#Div0
anyone,0,0,1,0,1,#Div0,#Div0,#Div0
accomplished,0,0,2,0,2,#Div0,#Div0,#Div0
acting,0,0,2,0,2,#Div0,#Div0,#Div0
knowlege,0,0,1,0,1,#Div0,#Div0,#Div0
health,0,1,0,0,1,0.0,#Div0,#Div0
claim,0,0,3,0,3,#Div0,#Div0,#Div0
explain,0,0,15,0,15,#Div0,#Div0,#Div0
possibilities,0,0,2,0,2,#Div0,#Div0,#Div0
personnal,0,0,1,0,1,#Div0,#Div0,#Div0
stayed,0,0,2,0,2,#Div0,#Div0,#Div0
teenagers,0,0,1,0,1,#Div0,#Div0,#Div0
adress,0,0,1,0,1,#Div0,#Div0,#Div0
flexible,0,0,0,3,3,#Div0,0.0,#Div0
do,0,0,229,0,229,#Div0,#Div0,#Div0
only,0,0,8,0,8,#Div0,#Div0,#Div0
improved,0,0,2,0,2,#Div0,#Div0,#Div0
disagreeing,0,0,1,0,1,#Div0,#Div0,#Div0
cars,0,0,2,0,2,#Div0,#Div0,#Div0
secured,0,0,0,1,1,#Div0,0.0,#Div0
wake,0,0,3,0,3,#Div0,#Div0,#Div0
make,0,0,132,3,135,#Div0,0.0,#Div0
cured,0,0,1,0,1,#Div0,#Div0,#Div0
Excellent,0,0,1,0,1,#Div0,#Div0,#Div0
successful,0,0,41,0,41,#Div0,#Div0,#Div0
cool,0,0,1,2,3,#Div0,0.0,#Div0
musical,0,0,1,0,1,#Div0,#Div0,#Div0
crossing,0,0,1,0,1,#Div0,#Div0,#Div0
regular,0,0,2,0,2,#Div0,#Div0,#Div0
exercise,0,0,2,0,2,#Div0,#Div0,#Div0
comparative,0,1,0,0,1,0.0,#Div0,#Div0
available,0,0,3,3,6,#Div0,0.0,#Div0
alot,0,0,13,0,13,#Div0,#Div0,#Div0
win,0,0,0,1,1,#Div0,0.0,#Div0
etc,0,0,1,0,1,#Div0,#Div0,#Div0
enegy,0,0,1,0,1,#Div0,#Div0,#Div0
talking,0,1,5,2,8,0.0,0.0,#Div0
helping,0,0,52,0,52,#Div0,#Div0,#Div0
goals,0,0,1,0,1,#Div0,#Div0,#Div0
sould,0,0,1,0,1,#Div0,#Div0,#Div0
memory,0,0,2,0,2,#Div0,#Div0,#Div0
tongue,0,0,1,0,1,#Div0,#Div0,#Div0
satisfied,0,0,1,0,1,#Div0,#Div0,#Div0
extra,0,0,2,2,4,#Div0,0.0,#Div0
obtained,0,0,0,1,1,#Div0,0.0,#Div0
country,0,0,2,0,2,#Div0,#Div0,#Div0
ordinary,0,0,1,0,1,#Div0,#Div0,#Div0
logical,0,0,1,0,1,#Div0,#Div0,#Div0
seek,0,0,0,2,2,#Div0,0.0,#Div0
shy,0,0,1,0,1,#Div0,#Div0,#Div0
digital,0,0,1,0,1,#Div0,#Div0,#Div0
leave,0,0,6,0,6,#Div0,#Div0,#Div0
jams,0,0,0,1,1,#Div0,0.0,#Div0
advertising,0,0,2,0,2,#Div0,#Div0,#Div0
Lonely,0,0,1,0,1,#Div0,#Div0,#Div0
qualities,0,0,1,0,1,#Div0,#Div0,#Div0
resulting,0,0,3,0,3,#Div0,#Div0,#Div0
predicted,0,0,1,0,1,#Div0,#Div0,#Div0
eaten,0,0,0,1,1,#Div0,0.0,#Div0
scheme,0,0,0,1,1,#Div0,0.0,#Div0
memorized,0,0,1,0,1,#Div0,#Div0,#Div0
Red,0,0,1,0,1,#Div0,#Div0,#Div0
has,0,0,102,5,107,#Div0,0.0,#Div0
ner,0,0,1,0,1,#Div0,#Div0,#Div0
seize,0,0,0,1,1,#Div0,0.0,#Div0
Total,0,0,1,0,1,#Div0,#Div0,#Div0
personality,0,0,4,0,4,#Div0,#Div0,#Div0
urban,0,0,1,0,1,#Div0,#Div0,#Div0
lie,0,0,1,0,1,#Div0,#Div0,#Div0
trial,0,0,1,0,1,#Div0,#Div0,#Div0
retired,0,0,3,0,3,#Div0,#Div0,#Div0
II,0,0,2,0,2,#Div0,#Div0,#Div0
practitioners,0,0,1,0,1,#Div0,#Div0,#Div0
testing,0,0,2,0,2,#Div0,#Div0,#Div0
tired,0,0,5,0,5,#Div0,#Div0,#Div0
things,0,0,3,0,3,#Div0,#Div0,#Div0
wonderful,0,0,1,0,1,#Div0,#Div0,#Div0
offcourse,0,0,1,0,1,#Div0,#Div0,#Div0
assisting,0,0,1,0,1,#Div0,#Div0,#Div0
working,1,3,21,0,25,0.25,1.0,0.4
stop,0,0,6,1,7,#Div0,0.0,#Div0
runs,1,0,0,0,1,1.0,1.0,1.0
amount,0,0,13,0,13,#Div0,#Div0,#Div0
owning,0,0,3,0,3,#Div0,#Div0,#Div0
spite,0,0,1,0,1,#Div0,#Div0,#Div0
bare,0,0,0,1,1,#Div0,0.0,#Div0
external,0,0,2,0,2,#Div0,#Div0,#Div0
determining,0,0,2,0,2,#Div0,#Div0,#Div0
several,0,2,14,0,16,0.0,#Div0,#Div0
face,0,0,1,14,15,#Div0,0.0,#Div0
seem,0,0,16,0,16,#Div0,#Div0,#Div0
takes,0,0,5,8,13,#Div0,0.0,#Div0
technical,0,0,1,0,1,#Div0,#Div0,#Div0
donot,0,0,1,0,1,#Div0,#Div0,#Div0
ideas,0,0,4,0,4,#Div0,#Div0,#Div0
advance,0,0,0,1,1,#Div0,0.0,#Div0
wedding,0,0,1,0,1,#Div0,#Div0,#Div0
ended,0,0,1,0,1,#Div0,#Div0,#Div0
safer,0,0,1,0,1,#Div0,#Div0,#Div0
offer,0,0,1,3,4,#Div0,0.0,#Div0
lazing,0,0,1,0,1,#Div0,#Div0,#Div0
eat,0,0,7,0,7,#Div0,#Div0,#Div0
enforce,0,0,1,0,1,#Div0,#Div0,#Div0
party,0,0,1,0,1,#Div0,#Div0,#Div0
Seeing,0,0,1,2,3,#Div0,0.0,#Div0
worth,0,0,0,1,1,#Div0,0.0,#Div0
sharp,0,0,0,1,1,#Div0,0.0,#Div0
tomorrow,0,0,0,1,1,#Div0,0.0,#Div0
classes,0,0,3,0,3,#Div0,#Div0,#Div0
stopped,0,0,1,0,1,#Div0,#Div0,#Div0
decide,0,0,11,0,11,#Div0,#Div0,#Div0
holidays,0,0,1,0,1,#Div0,#Div0,#Div0
reason,0,0,3,0,3,#Div0,#Div0,#Div0
book,0,0,1,0,1,#Div0,#Div0,#Div0
surrounded,0,0,1,2,3,#Div0,0.0,#Div0
hires,0,0,1,0,1,#Div0,#Div0,#Div0
detailed,0,0,2,0,2,#Div0,#Div0,#Div0
boring,0,0,10,0,10,#Div0,#Div0,#Div0
ingredients,0,0,1,0,1,#Div0,#Div0,#Div0
active,0,0,0,4,4,#Div0,0.0,#Div0
card,0,0,1,0,1,#Div0,#Div0,#Div0
including,0,0,8,0,8,#Div0,#Div0,#Div0
continue,0,0,7,0,7,#Div0,#Div0,#Div0
paint,0,0,1,0,1,#Div0,#Div0,#Div0
perspective,0,0,0,1,1,#Div0,0.0,#Div0
aid,0,0,1,0,1,#Div0,#Div0,#Div0
play,0,2,3,2,7,0.0,0.0,#Div0
driven,0,0,0,1,1,#Div0,0.0,#Div0
workers,0,0,1,0,1,#Div0,#Div0,#Div0
obstacle,0,0,0,3,3,#Div0,0.0,#Div0
independant,0,0,1,0,1,#Div0,#Div0,#Div0
line,0,0,0,1,1,#Div0,0.0,#Div0
growing,0,0,3,6,9,#Div0,0.0,#Div0
learn,0,0,79,0,79,#Div0,#Div0,#Div0
myself,0,0,1,0,1,#Div0,#Div0,#Div0
got,0,0,12,0,12,#Div0,#Div0,#Div0
estimate,0,0,1,0,1,#Div0,#Div0,#Div0
Studying,0,0,1,0,1,#Div0,#Div0,#Div0
mates,0,0,1,0,1,#Div0,#Div0,#Div0
hiring,0,0,1,0,1,#Div0,#Div0,#Div0
moving,0,1,3,2,6,0.0,0.0,#Div0
acitivity,0,0,1,0,1,#Div0,#Div0,#Div0
entered,0,0,1,1,2,#Div0,0.0,#Div0
fascinated,0,0,1,0,1,#Div0,#Div0,#Div0
wonder,0,0,1,0,1,#Div0,#Div0,#Div0
supply,0,0,1,0,1,#Div0,#Div0,#Div0
are,0,0,376,0,376,#Div0,#Div0,#Div0
future,0,0,9,0,9,#Div0,#Div0,#Div0
level,0,0,4,5,9,#Div0,0.0,#Div0
dance,0,0,2,0,2,#Div0,#Div0,#Div0
sells,0,0,1,0,1,#Div0,#Div0,#Div0
notes,0,0,1,0,1,#Div0,#Div0,#Div0
becoming,0,0,7,0,7,#Div0,#Div0,#Div0
type,0,0,16,0,16,#Div0,#Div0,#Div0
try,0,0,63,0,63,#Div0,#Div0,#Div0
benificial,0,0,2,0,2,#Div0,#Div0,#Div0
waited,0,0,2,0,2,#Div0,#Div0,#Div0
esthetic,0,0,1,0,1,#Div0,#Div0,#Div0
arguing,0,0,1,0,1,#Div0,#Div0,#Div0
laws,0,0,1,0,1,#Div0,#Div0,#Div0
explore,2,0,2,1,5,1.0,0.6666666666666666,0.8
companies,0,0,4,0,4,#Div0,#Div0,#Div0
language,0,0,2,0,2,#Div0,#Div0,#Div0
defraud,0,0,1,0,1,#Div0,#Div0,#Div0
vacation,0,0,2,0,2,#Div0,#Div0,#Div0
knows,0,0,11,0,11,#Div0,#Div0,#Div0
sons,0,0,0,1,1,#Div0,0.0,#Div0
fullfill,0,0,1,0,1,#Div0,#Div0,#Div0
agents,0,0,1,0,1,#Div0,#Div0,#Div0
discard,0,0,0,1,1,#Div0,0.0,#Div0
Angeles,0,0,1,0,1,#Div0,#Div0,#Div0
gon,0,0,1,0,1,#Div0,#Div0,#Div0
emotionally,0,0,1,0,1,#Div0,#Div0,#Div0
reasons,0,0,1,0,1,#Div0,#Div0,#Div0
specializes,0,0,2,0,2,#Div0,#Div0,#Div0
deform,0,0,1,0,1,#Div0,#Div0,#Div0
shine,0,0,0,2,2,#Div0,0.0,#Div0
collecting,0,0,0,1,1,#Div0,0.0,#Div0
commom,0,0,1,0,1,#Div0,#Div0,#Div0
open,0,0,1,6,7,#Div0,0.0,#Div0
subjects,0,0,8,0,8,#Div0,#Div0,#Div0
quickly,0,0,0,1,1,#Div0,0.0,#Div0
creating,0,0,4,0,4,#Div0,#Div0,#Div0
Drink,0,0,1,0,1,#Div0,#Div0,#Div0
American,0,0,1,0,1,#Div0,#Div0,#Div0
fear,0,0,1,0,1,#Div0,#Div0,#Div0
loving,0,0,2,0,2,#Div0,#Div0,#Div0
sends,0,0,0,1,1,#Div0,0.0,#Div0
benefit,0,0,5,0,5,#Div0,#Div0,#Div0
undertand,0,0,1,0,1,#Div0,#Div0,#Div0
Bomb,0,0,1,0,1,#Div0,#Div0,#Div0
leads,0,0,1,12,13,#Div0,0.0,#Div0
deny,0,0,3,0,3,#Div0,#Div0,#Div0
behaviors,0,1,1,0,2,0.0,#Div0,#Div0
enjoyed,0,0,3,0,3,#Div0,#Div0,#Div0
continuing,0,0,1,0,1,#Div0,#Div0,#Div0
advertise,0,0,4,0,4,#Div0,#Div0,#Div0
marketting,0,0,1,0,1,#Div0,#Div0,#Div0
cannnot,0,0,1,0,1,#Div0,#Div0,#Div0
risk,0,0,2,0,2,#Div0,#Div0,#Div0
obliges,0,0,1,1,2,#Div0,0.0,#Div0
bright,0,0,1,1,2,#Div0,0.0,#Div0
existance,0,0,1,0,1,#Div0,#Div0,#Div0
impressed,0,0,2,0,2,#Div0,#Div0,#Div0
Limiting,0,0,1,0,1,#Div0,#Div0,#Div0
filling,1,0,0,0,1,1.0,1.0,1.0
romantic,0,0,1,0,1,#Div0,#Div0,#Div0
languages,0,0,1,0,1,#Div0,#Div0,#Div0
arrived,0,0,3,0,3,#Div0,#Div0,#Div0
Modern,0,0,1,0,1,#Div0,#Div0,#Div0
pluck,0,0,0,1,1,#Div0,0.0,#Div0
exposing,0,0,1,0,1,#Div0,#Div0,#Div0
huge,0,0,10,1,11,#Div0,0.0,#Div0
science,0,0,1,0,1,#Div0,#Div0,#Div0
jeopardizing,0,0,1,0,1,#Div0,#Div0,#Div0
defined,0,0,0,1,1,#Div0,0.0,#Div0
deeply,0,0,0,1,1,#Div0,0.0,#Div0
right,0,0,13,0,13,#Div0,#Div0,#Div0
freedom,0,0,2,0,2,#Div0,#Div0,#Div0
obvious,0,0,2,0,2,#Div0,#Div0,#Div0
opportunities,0,0,2,0,2,#Div0,#Div0,#Div0
Compared,0,0,1,0,1,#Div0,#Div0,#Div0
bolt,0,0,1,0,1,#Div0,#Div0,#Div0
local,0,0,17,0,17,#Div0,#Div0,#Div0
temperature,0,2,0,0,2,0.0,#Div0,#Div0
feed,0,0,1,1,2,#Div0,0.0,#Div0
grow,0,0,3,7,10,#Div0,0.0,#Div0
start,0,0,18,2,20,#Div0,0.0,#Div0
sake,0,0,1,0,1,#Div0,#Div0,#Div0
emphasize,0,0,2,0,2,#Div0,#Div0,#Div0
first,0,0,24,3,27,#Div0,0.0,#Div0
described,0,0,2,0,2,#Div0,#Div0,#Div0
opposite,0,0,2,0,2,#Div0,#Div0,#Div0
closer,0,0,0,1,1,#Div0,0.0,#Div0
slope,0,0,1,0,1,#Div0,#Div0,#Div0
projects,0,0,1,0,1,#Div0,#Div0,#Div0
hoe,0,0,1,0,1,#Div0,#Div0,#Div0
second,0,0,8,1,9,#Div0,0.0,#Div0
refocus,0,0,0,1,1,#Div0,0.0,#Div0
disabled,0,1,0,0,1,0.0,#Div0,#Div0
powerfull,0,0,0,2,2,#Div0,0.0,#Div0
receive,0,0,3,1,4,#Div0,0.0,#Div0
minding,0,0,1,0,1,#Div0,#Div0,#Div0
hated,0,0,1,0,1,#Div0,#Div0,#Div0
art,0,0,1,0,1,#Div0,#Div0,#Div0
strenght,0,0,0,1,1,#Div0,0.0,#Div0
promoting,0,0,2,1,3,#Div0,0.0,#Div0
liek,0,0,1,0,1,#Div0,#Div0,#Div0
joined,0,0,1,0,1,#Div0,#Div0,#Div0
millions,0,0,2,0,2,#Div0,#Div0,#Div0
presenting,0,0,1,0,1,#Div0,#Div0,#Div0
lives,0,0,9,0,9,#Div0,#Div0,#Div0
keeping,0,0,2,0,2,#Div0,#Div0,#Div0
content,0,0,1,0,1,#Div0,#Div0,#Div0
conversations,0,0,1,0,1,#Div0,#Div0,#Div0
wide,0,0,0,12,12,#Div0,0.0,#Div0
horrifying,0,0,0,1,1,#Div0,0.0,#Div0
addicted,0,0,0,1,1,#Div0,0.0,#Div0
insure,0,0,0,1,1,#Div0,0.0,#Div0
let,0,0,8,0,8,#Div0,#Div0,#Div0
method,0,0,4,0,4,#Div0,#Div0,#Div0
wont,0,0,2,0,2,#Div0,#Div0,#Div0
Human,0,0,1,0,1,#Div0,#Div0,#Div0
regreted,0,0,1,0,1,#Div0,#Div0,#Div0
communication,0,0,1,0,1,#Div0,#Div0,#Div0
Young,0,0,2,0,2,#Div0,#Div0,#Div0
founded,0,0,1,0,1,#Div0,#Div0,#Div0
sculpture,0,1,0,0,1,0.0,#Div0,#Div0
performing,0,0,1,0,1,#Div0,#Div0,#Div0
losing,0,0,0,4,4,#Div0,0.0,#Div0
achieved,0,0,2,1,3,#Div0,0.0,#Div0
matters,0,0,2,0,2,#Div0,#Div0,#Div0
hearing,0,0,1,0,1,#Div0,#Div0,#Div0
intelligent,0,0,2,0,2,#Div0,#Div0,#Div0
hep,0,0,1,0,1,#Div0,#Div0,#Div0
specialist,0,0,1,0,1,#Div0,#Div0,#Div0
Academic,0,0,1,0,1,#Div0,#Div0,#Div0
grown,0,0,1,2,3,#Div0,0.0,#Div0
stage,0,0,1,4,5,#Div0,0.0,#Div0
reserve,0,0,1,0,1,#Div0,#Div0,#Div0
getting,0,0,14,1,15,#Div0,0.0,#Div0
controled,0,0,1,0,1,#Div0,#Div0,#Div0
contribute,0,0,2,0,2,#Div0,#Div0,#Div0
pieces,0,0,1,0,1,#Div0,#Div0,#Div0
choices,0,0,1,0,1,#Div0,#Div0,#Div0
games,0,0,2,0,2,#Div0,#Div0,#Div0
spend,0,0,11,42,53,#Div0,0.0,#Div0
goes,0,2,5,1,8,0.0,0.0,#Div0
developing,0,0,8,1,9,#Div0,0.0,#Div0
status,0,0,2,0,2,#Div0,#Div0,#Div0
lines,0,0,2,0,2,#Div0,#Div0,#Div0
possible,0,0,2,0,2,#Div0,#Div0,#Div0
bing,0,0,1,0,1,#Div0,#Div0,#Div0
born,0,0,3,1,4,#Div0,0.0,#Div0
going,0,5,38,4,47,0.0,0.0,#Div0
think,0,0,195,0,195,#Div0,#Div0,#Div0
arriving,0,0,1,0,1,#Div0,#Div0,#Div0
adjust,0,0,1,1,2,#Div0,0.0,#Div0
charge,0,0,1,0,1,#Div0,#Div0,#Div0
aiming,0,0,0,1,1,#Div0,0.0,#Div0
effecient,0,0,1,0,1,#Div0,#Div0,#Div0
explaining,0,0,2,0,2,#Div0,#Div0,#Div0
having,0,0,38,6,44,#Div0,0.0,#Div0
held,0,0,0,1,1,#Div0,0.0,#Div0
geting,0,0,1,0,1,#Div0,#Div0,#Div0
listening,0,0,2,0,2,#Div0,#Div0,#Div0
compromise,0,0,1,0,1,#Div0,#Div0,#Div0
European,0,0,3,0,3,#Div0,#Div0,#Div0
gas,0,0,1,0,1,#Div0,#Div0,#Div0
saw,0,0,7,0,7,#Div0,#Div0,#Div0
colors,0,0,1,0,1,#Div0,#Div0,#Div0
flowing,1,0,0,0,1,1.0,1.0,1.0
developments,0,0,1,0,1,#Div0,#Div0,#Div0
react,0,1,4,0,5,0.0,#Div0,#Div0
monthly,0,0,1,0,1,#Div0,#Div0,#Div0
tough,0,0,2,0,2,#Div0,#Div0,#Div0
clothing,0,0,1,0,1,#Div0,#Div0,#Div0
fly,0,0,1,0,1,#Div0,#Div0,#Div0
volunteers,0,0,1,0,1,#Div0,#Div0,#Div0
Thai,0,0,1,0,1,#Div0,#Div0,#Div0
admire,0,0,1,0,1,#Div0,#Div0,#Div0
role,0,0,3,0,3,#Div0,#Div0,#Div0
states,0,0,2,0,2,#Div0,#Div0,#Div0
store,0,0,4,0,4,#Div0,#Div0,#Div0
rise,0,0,2,2,4,#Div0,0.0,#Div0
condition,0,0,1,0,1,#Div0,#Div0,#Div0
maintenance,0,0,1,0,1,#Div0,#Div0,#Div0
comparing,0,1,0,0,1,0.0,#Div0,#Div0
exists,0,0,1,0,1,#Div0,#Div0,#Div0
asked,0,0,10,0,10,#Div0,#Div0,#Div0
current,0,0,5,0,5,#Div0,#Div0,#Div0
fantastic,0,0,1,1,2,#Div0,0.0,#Div0
issue,0,0,2,0,2,#Div0,#Div0,#Div0
gotten,0,0,1,0,1,#Div0,#Div0,#Div0
steady,0,0,0,3,3,#Div0,0.0,#Div0
allows,0,0,7,0,7,#Div0,#Div0,#Div0
visual,0,0,1,0,1,#Div0,#Div0,#Div0
Being,0,0,1,0,1,#Div0,#Div0,#Div0
connected,0,0,1,2,3,#Div0,0.0,#Div0
affect,0,0,4,0,4,#Div0,#Div0,#Div0
war,0,0,1,0,1,#Div0,#Div0,#Div0
empowering,0,0,1,0,1,#Div0,#Div0,#Div0
placing,0,0,2,0,2,#Div0,#Div0,#Div0
sometimes,0,0,2,0,2,#Div0,#Div0,#Div0
Leaving,0,0,1,0,1,#Div0,#Div0,#Div0
information,0,0,3,0,3,#Div0,#Div0,#Div0
informational,0,0,1,0,1,#Div0,#Div0,#Div0
studied,0,8,8,0,16,0.0,#Div0,#Div0
emitted,0,0,1,0,1,#Div0,#Div0,#Div0
cable,0,0,1,0,1,#Div0,#Div0,#Div0
forced,0,0,0,4,4,#Div0,0.0,#Div0
consists,0,0,1,0,1,#Div0,#Div0,#Div0
accelerating,0,0,0,1,1,#Div0,0.0,#Div0
showed,0,0,8,0,8,#Div0,#Div0,#Div0
Working,0,0,1,0,1,#Div0,#Div0,#Div0
side-effects,0,0,1,0,1,#Div0,#Div0,#Div0
Vinci,0,0,1,0,1,#Div0,#Div0,#Div0
Gillette,0,0,1,0,1,#Div0,#Div0,#Div0
changed,0,0,5,1,6,#Div0,0.0,#Div0
fixing,0,0,0,1,1,#Div0,0.0,#Div0
careful,0,0,2,0,2,#Div0,#Div0,#Div0
noticed,0,0,3,0,3,#Div0,#Div0,#Div0
much,0,0,25,0,25,#Div0,#Div0,#Div0
drink,0,1,2,0,3,0.0,#Div0,#Div0
First,0,0,2,0,2,#Div0,#Div0,#Div0
effort,0,0,1,0,1,#Div0,#Div0,#Div0
collected,0,0,0,1,1,#Div0,0.0,#Div0
daughter,0,0,2,0,2,#Div0,#Div0,#Div0
coming,0,1,3,0,4,0.0,#Div0,#Div0
commuting,0,0,3,0,3,#Div0,#Div0,#Div0
act,0,0,1,0,1,#Div0,#Div0,#Div0
supporting,0,0,0,2,2,#Div0,0.0,#Div0
protected,1,0,0,2,3,1.0,0.3333333333333333,0.5
call,0,1,6,0,7,0.0,#Div0,#Div0
shopping,0,0,5,0,5,#Div0,#Div0,#Div0
one,0,0,1,0,1,#Div0,#Div0,#Div0
wasted,0,0,0,2,2,#Div0,0.0,#Div0
score,0,0,1,0,1,#Div0,#Div0,#Div0
gift,0,0,1,0,1,#Div0,#Div0,#Div0
i,0,0,45,0,45,#Div0,#Div0,#Div0
tempted,0,0,0,1,1,#Div0,0.0,#Div0
shoes,0,0,1,0,1,#Div0,#Div0,#Div0
feelings,0,0,1,0,1,#Div0,#Div0,#Div0
sue,0,0,1,0,1,#Div0,#Div0,#Div0
forecasted,0,0,0,1,1,#Div0,0.0,#Div0
continous,0,0,1,0,1,#Div0,#Div0,#Div0
younger,0,0,1,0,1,#Div0,#Div0,#Div0
remembered,0,0,2,0,2,#Div0,#Div0,#Div0
semesters,0,0,0,1,1,#Div0,0.0,#Div0
reserving,0,0,1,0,1,#Div0,#Div0,#Div0
whole,0,0,8,2,10,#Div0,0.0,#Div0
mere,0,0,1,0,1,#Div0,#Div0,#Div0
rectangular,0,0,1,0,1,#Div0,#Div0,#Div0
opposing,0,0,1,0,1,#Div0,#Div0,#Div0
hard,0,0,10,1,11,#Div0,0.0,#Div0
acknowledged,0,0,1,0,1,#Div0,#Div0,#Div0
stopping,0,0,1,0,1,#Div0,#Div0,#Div0
pricy,0,0,1,0,1,#Div0,#Div0,#Div0
standing,0,0,1,0,1,#Div0,#Div0,#Div0
Last,0,0,2,0,2,#Div0,#Div0,#Div0
professional,0,0,4,0,4,#Div0,#Div0,#Div0
directed,0,0,0,1,1,#Div0,0.0,#Div0
reduced,0,0,3,0,3,#Div0,#Div0,#Div0
accomplish,0,0,3,0,3,#Div0,#Div0,#Div0
tell,0,0,9,0,9,#Div0,#Div0,#Div0
contracted,0,0,1,0,1,#Div0,#Div0,#Div0
encourages,0,0,1,2,3,#Div0,0.0,#Div0
expect,0,0,1,0,1,#Div0,#Div0,#Div0
consider,0,0,12,0,12,#Div0,#Div0,#Div0
rely,0,0,0,3,3,#Div0,0.0,#Div0
occured,0,0,1,0,1,#Div0,#Div0,#Div0
discount,0,0,1,0,1,#Div0,#Div0,#Div0
moves,0,1,0,0,1,0.0,#Div0,#Div0
bit,0,0,2,2,4,#Div0,0.0,#Div0
recreate,0,0,1,0,1,#Div0,#Div0,#Div0
distract,0,0,0,1,1,#Div0,0.0,#Div0
comprehend,0,0,4,0,4,#Div0,#Div0,#Div0
scheduled,0,0,2,0,2,#Div0,#Div0,#Div0
interacted,0,0,1,0,1,#Div0,#Div0,#Div0
appartments,0,0,1,0,1,#Div0,#Div0,#Div0
attractive,0,0,1,0,1,#Div0,#Div0,#Div0
Kimura,0,0,1,0,1,#Div0,#Div0,#Div0
expands,0,0,0,1,1,#Div0,0.0,#Div0
visualize,0,0,0,1,1,#Div0,0.0,#Div0
reasoning,0,0,1,0,1,#Div0,#Div0,#Div0
Using,0,0,3,0,3,#Div0,#Div0,#Div0
period,0,0,6,0,6,#Div0,#Div0,#Div0
hurt,0,0,1,0,1,#Div0,#Div0,#Div0
exact,0,0,2,0,2,#Div0,#Div0,#Div0
ensures,0,0,1,0,1,#Div0,#Div0,#Div0
man,0,0,10,0,10,#Div0,#Div0,#Div0
such,0,1,13,0,14,0.0,#Div0,#Div0
take,0,0,61,17,78,#Div0,0.0,#Div0
past,0,0,6,0,6,#Div0,#Div0,#Div0
church,0,0,1,0,1,#Div0,#Div0,#Div0
Market,0,0,1,0,1,#Div0,#Div0,#Div0
beyond,0,0,0,1,1,#Div0,0.0,#Div0
require,0,0,4,1,5,#Div0,0.0,#Div0
improvement,0,0,1,0,1,#Div0,#Div0,#Div0
removing,0,0,1,0,1,#Div0,#Div0,#Div0
mental,0,0,4,0,4,#Div0,#Div0,#Div0
deep,0,0,0,3,3,#Div0,0.0,#Div0
eastern,0,0,1,0,1,#Div0,#Div0,#Div0
founder,0,0,1,0,1,#Div0,#Div0,#Div0
left,0,0,2,1,3,#Div0,0.0,#Div0
basic,0,0,4,3,7,#Div0,0.0,#Div0
agency,0,0,1,0,1,#Div0,#Div0,#Div0
agreed,0,0,2,0,2,#Div0,#Div0,#Div0
high-speed,0,0,1,0,1,#Div0,#Div0,#Div0
energetic,0,0,1,0,1,#Div0,#Div0,#Div0
dealing,0,0,1,0,1,#Div0,#Div0,#Div0
lecture,0,0,1,0,1,#Div0,#Div0,#Div0
mislead,0,0,0,1,1,#Div0,0.0,#Div0
provides,0,0,3,0,3,#Div0,#Div0,#Div0
commit,0,0,1,0,1,#Div0,#Div0,#Div0
avaliable,0,0,1,0,1,#Div0,#Div0,#Div0
post,0,0,1,0,1,#Div0,#Div0,#Div0
endless,0,0,0,1,1,#Div0,0.0,#Div0
solving,0,0,2,0,2,#Div0,#Div0,#Div0
clear,0,0,1,5,6,#Div0,0.0,#Div0
advertisement,0,0,9,0,9,#Div0,#Div0,#Div0
Living,0,0,1,0,1,#Div0,#Div0,#Div0
cutting,0,0,0,1,1,#Div0,0.0,#Div0
aslo,0,0,1,0,1,#Div0,#Div0,#Div0
raising,0,0,5,0,5,#Div0,#Div0,#Div0
making,0,0,20,0,20,#Div0,#Div0,#Div0
tourists,0,0,1,0,1,#Div0,#Div0,#Div0
price,0,0,3,0,3,#Div0,#Div0,#Div0
mean,0,0,19,0,19,#Div0,#Div0,#Div0
happens,0,0,4,0,4,#Div0,#Div0,#Div0
depended,0,0,1,0,1,#Div0,#Div0,#Div0
economy,0,0,2,0,2,#Div0,#Div0,#Div0
Resulting,0,0,1,0,1,#Div0,#Div0,#Div0
points,0,0,0,1,1,#Div0,0.0,#Div0
absurd,0,0,1,0,1,#Div0,#Div0,#Div0
source,0,0,1,0,1,#Div0,#Div0,#Div0
advanced,0,0,5,2,7,#Div0,0.0,#Div0
chase,0,0,0,1,1,#Div0,0.0,#Div0
advantages,0,0,2,0,2,#Div0,#Div0,#Div0
fact,0,0,2,0,2,#Div0,#Div0,#Div0
prepare,0,0,2,1,3,#Div0,0.0,#Div0
spare,0,0,1,2,3,#Div0,0.0,#Div0
reap,0,0,0,1,1,#Div0,0.0,#Div0
explained,0,0,3,0,3,#Div0,#Div0,#Div0
encourage,0,0,3,0,3,#Div0,#Div0,#Div0
enable,0,0,2,0,2,#Div0,#Div0,#Div0
eminent,0,0,1,0,1,#Div0,#Div0,#Div0
metropolitan,0,0,1,0,1,#Div0,#Div0,#Div0
existence,0,0,1,0,1,#Div0,#Div0,#Div0
tells,0,0,5,0,5,#Div0,#Div0,#Div0
enjoyment,0,0,1,0,1,#Div0,#Div0,#Div0
brave,0,0,6,0,6,#Div0,#Div0,#Div0
new,0,0,169,3,172,#Div0,0.0,#Div0
compromising,0,0,1,0,1,#Div0,#Div0,#Div0
twenty-five,0,0,1,0,1,#Div0,#Div0,#Div0
serving,0,0,1,0,1,#Div0,#Div0,#Div0
figure,0,0,2,0,2,#Div0,#Div0,#Div0
worked,0,1,7,0,8,0.0,#Div0,#Div0
decent,0,0,2,0,2,#Div0,#Div0,#Div0
specialized,0,0,30,0,30,#Div0,#Div0,#Div0
world,0,0,3,5,8,#Div0,0.0,#Div0
nominate,0,0,1,0,1,#Div0,#Div0,#Div0
travel,0,14,21,0,35,0.0,#Div0,#Div0
refer,0,0,1,0,1,#Div0,#Div0,#Div0
employ,0,0,1,0,1,#Div0,#Div0,#Div0
correction,0,0,0,1,1,#Div0,0.0,#Div0
broke,0,0,0,1,1,#Div0,0.0,#Div0
mostof,0,0,1,0,1,#Div0,#Div0,#Div0
hired,0,0,1,0,1,#Div0,#Div0,#Div0
typical,0,0,5,0,5,#Div0,#Div0,#Div0
explanation,0,0,3,0,3,#Div0,#Div0,#Div0
final,0,0,3,0,3,#Div0,#Div0,#Div0
Helping,0,0,1,0,1,#Div0,#Div0,#Div0
tour,0,0,23,0,23,#Div0,#Div0,#Div0
describe,0,0,2,0,2,#Div0,#Div0,#Div0
towards,0,0,1,0,1,#Div0,#Div0,#Div0
possibility,0,0,3,0,3,#Div0,#Div0,#Div0
thinking,0,0,10,0,10,#Div0,#Div0,#Div0
model,0,0,2,0,2,#Div0,#Div0,#Div0
admired,0,0,2,0,2,#Div0,#Div0,#Div0
express,0,0,1,0,1,#Div0,#Div0,#Div0
case,0,0,6,0,6,#Div0,#Div0,#Div0
sold,0,0,1,0,1,#Div0,#Div0,#Div0
sustained,0,0,0,1,1,#Div0,0.0,#Div0
Acording,0,0,1,0,1,#Div0,#Div0,#Div0
intense,0,0,0,1,1,#Div0,0.0,#Div0
repeat,0,0,4,0,4,#Div0,#Div0,#Div0
quality,0,0,7,0,7,#Div0,#Div0,#Div0
entrepreneurial,0,0,1,0,1,#Div0,#Div0,#Div0
immerse,0,0,0,1,1,#Div0,0.0,#Div0
didn,0,0,2,0,2,#Div0,#Div0,#Div0
atmosphere,0,0,0,1,1,#Div0,0.0,#Div0
purpose,0,0,5,0,5,#Div0,#Div0,#Div0
older,0,0,1,0,1,#Div0,#Div0,#Div0
giving,0,0,5,5,10,#Div0,0.0,#Div0
solar,0,0,1,0,1,#Div0,#Div0,#Div0
further,0,0,3,0,3,#Div0,#Div0,#Div0
shows,0,0,9,2,11,#Div0,0.0,#Div0
revolutionized,0,0,1,0,1,#Div0,#Div0,#Div0
wil,0,0,2,0,2,#Div0,#Div0,#Div0
selfish,0,0,3,0,3,#Div0,#Div0,#Div0
amounts,0,0,1,0,1,#Div0,#Div0,#Div0
look,0,0,18,4,22,#Div0,0.0,#Div0
seen,0,0,8,0,8,#Div0,#Div0,#Div0
money,0,0,2,1,3,#Div0,0.0,#Div0
decided,0,0,6,0,6,#Div0,#Div0,#Div0
adn,0,0,1,0,1,#Div0,#Div0,#Div0
perception,0,0,0,1,1,#Div0,0.0,#Div0
handicapped,0,1,0,0,1,0.0,#Div0,#Div0
required,0,0,9,0,9,#Div0,#Div0,#Div0
lessen,0,0,1,0,1,#Div0,#Div0,#Div0
thinks,0,0,2,0,2,#Div0,#Div0,#Div0
genuine,0,0,1,0,1,#Div0,#Div0,#Div0
wise,0,0,1,0,1,#Div0,#Div0,#Div0
frozen,0,0,1,0,1,#Div0,#Div0,#Div0
Have,0,0,3,0,3,#Div0,#Div0,#Div0
political,0,0,4,0,4,#Div0,#Div0,#Div0
structure,1,0,0,1,2,1.0,0.5,0.6666666666666666
pains,0,0,0,1,1,#Div0,0.0,#Div0
guided,0,0,5,0,5,#Div0,#Div0,#Div0
progressed,0,0,1,0,1,#Div0,#Div0,#Div0
question,0,0,2,0,2,#Div0,#Div0,#Div0
policies,0,0,1,0,1,#Div0,#Div0,#Div0
fidelity,0,0,1,0,1,#Div0,#Div0,#Div0
abstract,0,0,2,0,2,#Div0,#Div0,#Div0
necessity,0,0,2,0,2,#Div0,#Div0,#Div0
genetic,0,0,1,0,1,#Div0,#Div0,#Div0
becomes,0,0,4,0,4,#Div0,#Div0,#Div0
strange,0,0,3,0,3,#Div0,#Div0,#Div0
get,0,0,65,16,81,#Div0,0.0,#Div0
fall,0,0,2,0,2,#Div0,#Div0,#Div0
wider,0,0,0,2,2,#Div0,0.0,#Div0
so-called,0,0,2,0,2,#Div0,#Div0,#Div0
kind,0,0,39,0,39,#Div0,#Div0,#Div0
prevent,0,0,4,0,4,#Div0,#Div0,#Div0
experience,0,0,13,0,13,#Div0,#Div0,#Div0
results,0,0,2,0,2,#Div0,#Div0,#Div0
see,0,0,44,8,52,#Div0,0.0,#Div0
African,0,0,1,0,1,#Div0,#Div0,#Div0
flexibility,0,0,0,1,1,#Div0,0.0,#Div0
study,0,14,18,0,32,0.0,#Div0,#Div0
be,0,0,279,0,279,#Div0,#Div0,#Div0
generalize,0,0,3,0,3,#Div0,#Div0,#Div0
tied,0,0,0,2,2,#Div0,0.0,#Div0
elementary,0,0,1,0,1,#Div0,#Div0,#Div0
declare,0,0,1,0,1,#Div0,#Div0,#Div0
liberty,0,0,1,0,1,#Div0,#Div0,#Div0
useful,0,0,4,0,4,#Div0,#Div0,#Div0
removes,0,0,1,0,1,#Div0,#Div0,#Div0
conception,0,0,0,1,1,#Div0,0.0,#Div0
black,0,0,1,0,1,#Div0,#Div0,#Div0
burst,0,0,0,1,1,#Div0,0.0,#Div0
raise,0,0,1,0,1,#Div0,#Div0,#Div0
acknowledgements,0,0,1,0,1,#Div0,#Div0,#Div0
marry,0,1,1,0,2,0.0,#Div0,#Div0
wondered,0,0,1,0,1,#Div0,#Div0,#Div0
Considering,0,0,4,0,4,#Div0,#Div0,#Div0
affirm,0,0,1,0,1,#Div0,#Div0,#Div0
original,0,0,2,1,3,#Div0,0.0,#Div0
normal,0,0,8,0,8,#Div0,#Div0,#Div0
miss,1,0,1,3,5,1.0,0.25,0.4
competitive,0,0,1,0,1,#Div0,#Div0,#Div0
sacrificing,0,0,0,1,1,#Div0,0.0,#Div0
complained,0,0,1,0,1,#Div0,#Div0,#Div0
holding,0,0,1,0,1,#Div0,#Div0,#Div0
cold,0,0,1,0,1,#Div0,#Div0,#Div0
comfortable,0,0,2,3,5,#Div0,0.0,#Div0
branding,0,0,1,0,1,#Div0,#Div0,#Div0
guessed,0,0,1,0,1,#Div0,#Div0,#Div0
shape,0,0,1,1,2,#Div0,0.0,#Div0
name,0,0,1,0,1,#Div0,#Div0,#Div0
horizontal,0,0,0,3,3,#Div0,0.0,#Div0
fields,0,0,2,1,3,#Div0,0.0,#Div0
thier,0,0,1,0,1,#Div0,#Div0,#Div0
successes,0,0,2,0,2,#Div0,#Div0,#Div0
levels,0,0,2,0,2,#Div0,#Div0,#Div0
side,0,0,0,2,2,#Div0,0.0,#Div0
dynamic,0,0,0,2,2,#Div0,0.0,#Div0
insist,0,0,1,0,1,#Div0,#Div0,#Div0
houses,0,0,1,0,1,#Div0,#Div0,#Div0
general,0,0,17,0,17,#Div0,#Div0,#Div0
Knowing,0,0,3,0,3,#Div0,#Div0,#Div0
Club,0,0,1,0,1,#Div0,#Div0,#Div0
alter,0,0,1,0,1,#Div0,#Div0,#Div0
hear,0,0,3,0,3,#Div0,#Div0,#Div0
clothes,0,0,1,0,1,#Div0,#Div0,#Div0
responsabilities,0,0,1,0,1,#Div0,#Div0,#Div0
combination,0,0,1,0,1,#Div0,#Div0,#Div0
methods,0,0,3,0,3,#Div0,#Div0,#Div0
multiple,0,0,1,0,1,#Div0,#Div0,#Div0
fee,0,0,2,0,2,#Div0,#Div0,#Div0
cosmetic,0,0,4,0,4,#Div0,#Div0,#Div0
premises,0,0,0,1,1,#Div0,0.0,#Div0
trends,0,0,1,0,1,#Div0,#Div0,#Div0
needy,0,0,4,0,4,#Div0,#Div0,#Div0
control,0,0,1,2,3,#Div0,0.0,#Div0
fancy,0,0,2,0,2,#Div0,#Div0,#Div0
lot,0,0,70,0,70,#Div0,#Div0,#Div0
began,0,0,3,0,3,#Div0,#Div0,#Div0
English,0,0,1,0,1,#Div0,#Div0,#Div0
defended,0,0,0,2,2,#Div0,0.0,#Div0
Honda,0,0,1,0,1,#Div0,#Div0,#Div0
focussed,0,0,0,1,1,#Div0,0.0,#Div0
feeling,0,0,5,0,5,#Div0,#Div0,#Div0
stages,0,0,0,1,1,#Div0,0.0,#Div0
government,0,0,1,0,1,#Div0,#Div0,#Div0
Asian,0,0,1,0,1,#Div0,#Div0,#Div0
Enjoying,0,0,2,0,2,#Div0,#Div0,#Div0
advancing,0,0,0,1,1,#Div0,0.0,#Div0
works,1,0,9,0,10,1.0,1.0,1.0
advertisments,0,0,1,0,1,#Div0,#Div0,#Div0
pollute,0,0,1,0,1,#Div0,#Div0,#Div0
updated,0,0,1,0,1,#Div0,#Div0,#Div0
requires,0,0,11,4,15,#Div0,0.0,#Div0
endeavored,0,0,1,0,1,#Div0,#Div0,#Div0
streets,0,0,1,0,1,#Div0,#Div0,#Div0
actions,0,0,1,0,1,#Div0,#Div0,#Div0
read,0,0,11,0,11,#Div0,#Div0,#Div0
productive,0,0,1,0,1,#Div0,#Div0,#Div0
gives,0,0,12,16,28,#Div0,0.0,#Div0
leaders,0,0,1,0,1,#Div0,#Div0,#Div0
rewarding,0,1,1,0,2,0.0,#Div0,#Div0
contracting,0,0,1,0,1,#Div0,#Div0,#Div0
cutting-edge,0,0,0,1,1,#Div0,0.0,#Div0
approriate,0,0,1,0,1,#Div0,#Div0,#Div0
cycle,0,0,1,0,1,#Div0,#Div0,#Div0
lazy,0,0,1,0,1,#Div0,#Div0,#Div0
Second,0,0,2,0,2,#Div0,#Div0,#Div0
forget,0,0,2,1,3,#Div0,0.0,#Div0
types,0,0,9,0,9,#Div0,#Div0,#Div0
reasearch,0,0,1,0,1,#Div0,#Div0,#Div0
complement,0,0,0,2,2,#Div0,0.0,#Div0
color,0,0,2,0,2,#Div0,#Div0,#Div0
remembering,0,0,2,0,2,#Div0,#Div0,#Div0
toshiba,0,0,3,0,3,#Div0,#Div0,#Div0
consult,0,0,1,0,1,#Div0,#Div0,#Div0
filled,0,0,0,1,1,#Div0,0.0,#Div0
teaches,0,0,1,0,1,#Div0,#Div0,#Div0
punched,0,0,1,0,1,#Div0,#Div0,#Div0
dream,0,0,0,1,1,#Div0,0.0,#Div0
anybody,0,0,1,0,1,#Div0,#Div0,#Div0
invested,0,0,1,0,1,#Div0,#Div0,#Div0
advice,0,0,1,0,1,#Div0,#Div0,#Div0
day,0,0,4,0,4,#Div0,#Div0,#Div0
arrange,0,0,1,0,1,#Div0,#Div0,#Div0
maintain,0,0,3,0,3,#Div0,#Div0,#Div0
learing,0,0,2,0,2,#Div0,#Div0,#Div0
touched,0,0,0,1,1,#Div0,0.0,#Div0
percentage,0,0,1,0,1,#Div0,#Div0,#Div0
partner,0,0,1,0,1,#Div0,#Div0,#Div0
raised,0,0,1,1,2,#Div0,0.0,#Div0
bored,0,0,3,0,3,#Div0,#Div0,#Div0
leaving,1,0,2,1,4,1.0,0.5,0.6666666666666666
Knowledge,0,0,1,0,1,#Div0,#Div0,#Div0
disappointed,0,0,1,0,1,#Div0,#Div0,#Div0
join,0,0,5,0,5,#Div0,#Div0,#Div0
lens,0,0,0,1,1,#Div0,0.0,#Div0
create,0,0,7,1,8,#Div0,0.0,#Div0
areas,0,0,0,1,1,#Div0,0.0,#Div0
late,0,0,0,1,1,#Div0,0.0,#Div0
laptop,0,0,2,0,2,#Div0,#Div0,#Div0
stems,0,0,0,1,1,#Div0,0.0,#Div0
technologies,0,0,1,0,1,#Div0,#Div0,#Div0
history,0,0,3,0,3,#Div0,#Div0,#Div0
platform,0,0,0,1,1,#Div0,0.0,#Div0
creamy,0,0,1,0,1,#Div0,#Div0,#Div0
insult,0,1,0,0,1,0.0,#Div0,#Div0
year,0,0,1,0,1,#Div0,#Div0,#Div0
behavior,0,1,4,0,5,0.0,#Div0,#Div0
reached,0,0,1,6,7,#Div0,0.0,#Div0
weare,0,0,1,0,1,#Div0,#Div0,#Div0
finished,0,0,1,0,1,#Div0,#Div0,#Div0
cheat,0,0,0,2,2,#Div0,0.0,#Div0
being,0,0,16,0,16,#Div0,#Div0,#Div0
exams,0,0,1,0,1,#Div0,#Div0,#Div0
unusual,0,0,1,0,1,#Div0,#Div0,#Div0
carried,0,0,0,1,1,#Div0,0.0,#Div0
behave,0,1,2,0,3,0.0,#Div0,#Div0
democracy,0,0,2,0,2,#Div0,#Div0,#Div0
producer,0,0,1,0,1,#Div0,#Div0,#Div0
warmth,0,0,0,1,1,#Div0,0.0,#Div0
loved,0,0,1,0,1,#Div0,#Div0,#Div0
tests,0,0,1,0,1,#Div0,#Div0,#Div0
homeless,0,0,1,0,1,#Div0,#Div0,#Div0
plane,0,0,1,0,1,#Div0,#Div0,#Div0
takeing,0,0,1,0,1,#Div0,#Div0,#Div0
arrival,0,0,1,0,1,#Div0,#Div0,#Div0
recruiting,0,0,1,0,1,#Div0,#Div0,#Div0
staying,0,0,2,0,2,#Div0,#Div0,#Div0
saying,0,0,9,0,9,#Div0,#Div0,#Div0
unemployed,0,1,1,0,2,0.0,#Div0,#Div0
Paolo,0,0,1,0,1,#Div0,#Div0,#Div0
populated,0,0,1,0,1,#Div0,#Div0,#Div0
graduated,0,0,3,0,3,#Div0,#Div0,#Div0
alon,0,0,1,0,1,#Div0,#Div0,#Div0
convince,0,0,1,0,1,#Div0,#Div0,#Div0
joung,0,0,1,0,1,#Div0,#Div0,#Div0
bothered,0,0,1,0,1,#Div0,#Div0,#Div0
invention,0,0,1,0,1,#Div0,#Div0,#Div0
hire,0,0,3,0,3,#Div0,#Div0,#Div0
along,0,0,1,0,1,#Div0,#Div0,#Div0
saving,0,0,1,0,1,#Div0,#Div0,#Div0
happy,0,0,2,0,2,#Div0,#Div0,#Div0
unselfish,0,0,1,0,1,#Div0,#Div0,#Div0
willing,0,0,0,1,1,#Div0,0.0,#Div0
intrested,0,0,1,0,1,#Div0,#Div0,#Div0
germany,0,0,1,0,1,#Div0,#Div0,#Div0
impression,0,0,2,0,2,#Div0,#Div0,#Div0
carries,0,0,0,1,1,#Div0,0.0,#Div0
symbols,0,0,1,0,1,#Div0,#Div0,#Div0
anything,0,0,1,0,1,#Div0,#Div0,#Div0
entire,0,0,2,0,2,#Div0,#Div0,#Div0
foreing,0,0,1,0,1,#Div0,#Div0,#Div0
move,0,2,7,1,10,0.0,0.0,#Div0
benefited,0,0,1,0,1,#Div0,#Div0,#Div0
prices,0,0,3,0,3,#Div0,#Div0,#Div0
remove,0,0,1,0,1,#Div0,#Div0,#Div0
oun,0,0,1,0,1,#Div0,#Div0,#Div0
reducing,0,0,3,0,3,#Div0,#Div0,#Div0
duty,0,0,1,0,1,#Div0,#Div0,#Div0
progresses,0,0,1,0,1,#Div0,#Div0,#Div0
deceived,0,0,1,0,1,#Div0,#Div0,#Div0
above,0,0,1,0,1,#Div0,#Div0,#Div0
solution,0,0,1,0,1,#Div0,#Div0,#Div0
mroe,0,0,1,0,1,#Div0,#Div0,#Div0
mentioning,0,0,1,0,1,#Div0,#Div0,#Div0
clarify,0,0,1,0,1,#Div0,#Div0,#Div0
archeological,0,0,1,0,1,#Div0,#Div0,#Div0
ignoring,0,0,3,0,3,#Div0,#Div0,#Div0
restriction,0,0,0,1,1,#Div0,0.0,#Div0
broaden,0,0,0,1,1,#Div0,0.0,#Div0
activity,0,0,1,0,1,#Div0,#Div0,#Div0
journey,0,0,0,1,1,#Div0,0.0,#Div0
invited,0,0,2,0,2,#Div0,#Div0,#Div0
generic,0,0,1,0,1,#Div0,#Div0,#Div0
starting,0,0,2,1,3,#Div0,0.0,#Div0
posters,0,0,1,0,1,#Div0,#Div0,#Div0
discourage,0,0,1,0,1,#Div0,#Div0,#Div0
well-made,0,0,1,0,1,#Div0,#Div0,#Div0
native,0,0,1,0,1,#Div0,#Div0,#Div0
decides,0,0,2,0,2,#Div0,#Div0,#Div0
concerns,0,0,2,0,2,#Div0,#Div0,#Div0
provide,0,0,11,3,14,#Div0,0.0,#Div0
boomers,0,0,1,0,1,#Div0,#Div0,#Div0
gap,0,0,0,4,4,#Div0,0.0,#Div0
Doctor,0,0,1,0,1,#Div0,#Div0,#Div0
receives,0,0,1,0,1,#Div0,#Div0,#Div0
catch,0,0,0,1,1,#Div0,0.0,#Div0
Authority,0,0,1,0,1,#Div0,#Div0,#Div0
consequences,0,0,0,1,1,#Div0,0.0,#Div0
analyzed,0,0,1,0,1,#Div0,#Div0,#Div0
spoke,0,0,1,0,1,#Div0,#Div0,#Div0
realize,0,0,6,0,6,#Div0,#Div0,#Div0
rides,0,0,1,0,1,#Div0,#Div0,#Div0
related,0,0,12,0,12,#Div0,#Div0,#Div0
won,0,0,2,0,2,#Div0,#Div0,#Div0
univeristy,0,0,1,0,1,#Div0,#Div0,#Div0
cram,0,1,0,0,1,0.0,#Div0,#Div0
sight,0,0,1,0,1,#Div0,#Div0,#Div0
diet,0,0,1,0,1,#Div0,#Div0,#Div0
regarding,0,0,5,0,5,#Div0,#Div0,#Div0
fees,0,0,1,0,1,#Div0,#Div0,#Div0
details,0,0,2,0,2,#Div0,#Div0,#Div0
long,0,0,10,2,12,#Div0,0.0,#Div0
called,0,0,12,0,12,#Div0,#Div0,#Div0
previous,0,0,1,0,1,#Div0,#Div0,#Div0
advertized,0,0,1,0,1,#Div0,#Div0,#Div0
machine,0,0,1,0,1,#Div0,#Div0,#Div0
ethinic,0,0,1,0,1,#Div0,#Div0,#Div0
earning,0,0,1,0,1,#Div0,#Div0,#Div0
affected,0,0,2,0,2,#Div0,#Div0,#Div0
everyting,0,0,1,0,1,#Div0,#Div0,#Div0
opportunity,0,0,2,0,2,#Div0,#Div0,#Div0
definite,0,0,1,0,1,#Div0,#Div0,#Div0
attained,0,0,1,0,1,#Div0,#Div0,#Div0
watched,0,0,2,0,2,#Div0,#Div0,#Div0
describes,0,0,2,0,2,#Div0,#Div0,#Div0
time-consuming,0,0,0,2,2,#Div0,0.0,#Div0
diffused,0,0,0,1,1,#Div0,0.0,#Div0
decreasing,0,0,1,0,1,#Div0,#Div0,#Div0
passing,0,0,1,0,1,#Div0,#Div0,#Div0
Soft,0,0,3,0,3,#Div0,#Div0,#Div0
child,0,0,1,0,1,#Div0,#Div0,#Div0
conclude,0,0,5,0,5,#Div0,#Div0,#Div0
duties,0,0,1,0,1,#Div0,#Div0,#Div0
companions,0,0,1,0,1,#Div0,#Div0,#Div0
says,0,0,4,0,4,#Div0,#Div0,#Div0
X,0,0,1,0,1,#Div0,#Div0,#Div0
discussed,0,0,1,0,1,#Div0,#Div0,#Div0
regard,0,0,1,0,1,#Div0,#Div0,#Div0
gain,0,0,4,3,7,#Div0,0.0,#Div0
observed,0,0,3,0,3,#Div0,#Div0,#Div0
hands,0,0,1,0,1,#Div0,#Div0,#Div0
informations,0,0,1,0,1,#Div0,#Div0,#Div0
tax,0,0,1,0,1,#Div0,#Div0,#Div0
foresee,0,0,1,0,1,#Div0,#Div0,#Div0
playing,2,2,3,0,7,0.5,1.0,0.6666666666666666
interesting,0,2,7,0,9,0.0,#Div0,#Div0
aobut,0,0,1,0,1,#Div0,#Div0,#Div0
thats,0,0,1,0,1,#Div0,#Div0,#Div0
underlined,0,0,0,1,1,#Div0,0.0,#Div0
allowed,0,0,4,0,4,#Div0,#Div0,#Div0
Linux,0,0,1,0,1,#Div0,#Div0,#Div0
relieved,0,0,1,0,1,#Div0,#Div0,#Div0
historical,0,0,6,0,6,#Div0,#Div0,#Div0
exaggerate,0,0,1,0,1,#Div0,#Div0,#Div0
sources,0,0,4,2,6,#Div0,0.0,#Div0
sandwich,0,0,1,0,1,#Div0,#Div0,#Div0
worrying,0,0,1,0,1,#Div0,#Div0,#Div0
Regarding,0,0,1,0,1,#Div0,#Div0,#Div0
grant,0,0,1,1,2,#Div0,0.0,#Div0
Ali,0,0,1,0,1,#Div0,#Div0,#Div0
sick,0,1,0,0,1,0.0,#Div0,#Div0
casualties,0,1,0,0,1,0.0,#Div0,#Div0
solve,0,0,7,0,7,#Div0,#Div0,#Div0
stress,0,0,3,0,3,#Div0,#Div0,#Div0
Imagine,0,0,1,0,1,#Div0,#Div0,#Div0
concepts,0,0,6,0,6,#Div0,#Div0,#Div0
physical,0,0,6,0,6,#Div0,#Div0,#Div0
approaching,0,0,0,1,1,#Div0,0.0,#Div0
Society,0,0,1,0,1,#Div0,#Div0,#Div0
trains,0,0,4,0,4,#Div0,#Div0,#Div0
growths,0,0,1,0,1,#Div0,#Div0,#Div0
short,0,0,10,0,10,#Div0,#Div0,#Div0
credible,0,0,1,0,1,#Div0,#Div0,#Div0
haveing,0,0,1,0,1,#Div0,#Div0,#Div0
youg,0,0,1,0,1,#Div0,#Div0,#Div0
solid,0,0,0,1,1,#Div0,0.0,#Div0
hope,0,0,1,0,1,#Div0,#Div0,#Div0
according,0,0,6,0,6,#Div0,#Div0,#Div0
save,0,0,5,3,8,#Div0,0.0,#Div0
wooden,0,0,1,0,1,#Div0,#Div0,#Div0
natural,0,0,1,1,2,#Div0,0.0,#Div0
statement,0,0,1,0,1,#Div0,#Div0,#Div0
comprehending,0,0,1,0,1,#Div0,#Div0,#Div0
accept,0,0,4,0,4,#Div0,#Div0,#Div0
deciding,0,0,1,0,1,#Div0,#Div0,#Div0
point,0,0,10,2,12,#Div0,0.0,#Div0
team,0,0,1,0,1,#Div0,#Div0,#Div0
participating,0,0,2,0,2,#Div0,#Div0,#Div0
private,0,0,10,1,11,#Div0,0.0,#Div0
pride,0,0,1,0,1,#Div0,#Div0,#Div0
philosophical,0,0,1,0,1,#Div0,#Div0,#Div0
convinced,0,0,7,0,7,#Div0,#Div0,#Div0
profitable,0,0,1,0,1,#Div0,#Div0,#Div0
conditions,0,0,3,0,3,#Div0,#Div0,#Div0
comes,0,1,8,2,11,0.0,0.0,#Div0
idea,0,0,5,0,5,#Div0,#Div0,#Div0
goal,0,0,2,1,3,#Div0,0.0,#Div0
based,0,0,6,12,18,#Div0,0.0,#Div0
possitive,0,0,1,0,1,#Div0,#Div0,#Div0
deep-snow,0,0,1,0,1,#Div0,#Div0,#Div0
walking,0,0,1,0,1,#Div0,#Div0,#Div0
utilize,0,0,1,0,1,#Div0,#Div0,#Div0
Angry,0,0,1,0,1,#Div0,#Div0,#Div0
trafic,0,0,1,0,1,#Div0,#Div0,#Div0
strongly,0,0,0,1,1,#Div0,0.0,#Div0
diminish,0,0,1,1,2,#Div0,0.0,#Div0
efficient,0,0,1,0,1,#Div0,#Div0,#Div0
sixteen,0,0,1,0,1,#Div0,#Div0,#Div0
simultaneous,0,0,1,0,1,#Div0,#Div0,#Div0
additional,0,0,1,0,1,#Div0,#Div0,#Div0
cleaning,0,0,2,0,2,#Div0,#Div0,#Div0
regardless,0,0,2,0,2,#Div0,#Div0,#Div0
alternative,0,0,3,0,3,#Div0,#Div0,#Div0
vegetable,0,0,1,0,1,#Div0,#Div0,#Div0
Direct,0,0,1,0,1,#Div0,#Div0,#Div0
School,0,0,1,0,1,#Div0,#Div0,#Div0
faster,0,0,1,0,1,#Div0,#Div0,#Div0
planned,0,0,2,0,2,#Div0,#Div0,#Div0
According,0,0,3,0,3,#Div0,#Div0,#Div0
leaning,0,0,5,0,5,#Div0,#Div0,#Div0
existed,0,0,2,0,2,#Div0,#Div0,#Div0
Reducing,0,0,1,0,1,#Div0,#Div0,#Div0
cities,0,0,3,0,3,#Div0,#Div0,#Div0
implies,0,0,2,0,2,#Div0,#Div0,#Div0
King,0,0,1,0,1,#Div0,#Div0,#Div0
facility,0,0,1,0,1,#Div0,#Div0,#Div0
ways,0,0,2,2,4,#Div0,0.0,#Div0
specialization,0,0,1,0,1,#Div0,#Div0,#Div0
eith,0,0,1,0,1,#Div0,#Div0,#Div0
started,0,0,7,0,7,#Div0,#Div0,#Div0
ther,0,0,1,0,1,#Div0,#Div0,#Div0
popular,0,0,6,0,6,#Div0,#Div0,#Div0
referenced,0,0,1,0,1,#Div0,#Div0,#Div0
overtaken,0,0,0,1,1,#Div0,0.0,#Div0
in,0,0,0,3,3,#Div0,0.0,#Div0
quiting,0,0,1,0,1,#Div0,#Div0,#Div0
prepared,0,0,5,0,5,#Div0,#Div0,#Div0
Moving,0,0,0,1,1,#Div0,0.0,#Div0
uses,0,0,3,0,3,#Div0,#Div0,#Div0
friendly,0,0,0,1,1,#Div0,0.0,#Div0
eventual,0,0,1,0,1,#Div0,#Div0,#Div0
urges,0,0,1,0,1,#Div0,#Div0,#Div0
Talking,0,0,1,0,1,#Div0,#Div0,#Div0
blows,0,0,1,0,1,#Div0,#Div0,#Div0
blocked,0,0,0,2,2,#Div0,0.0,#Div0
under-developed,0,0,1,0,1,#Div0,#Div0,#Div0
gathering,0,0,1,0,1,#Div0,#Div0,#Div0
injured,0,0,1,0,1,#Div0,#Div0,#Div0
